Date,Detail,Customer/Supplier name,Dr,Cr,Balance
2024-07-01,Receipt,Cash Customer,0.0,29240.75,29240.75
2024-07-01,Receipt,Cash Customer,0.0,17188.05,46428.8
2024-07-01,Receipt,Ivy Fuels,0.0,1764.0,48192.8
2024-07-01,Receipt,Lumen Traders,0.0,10823.2,59016.0
2024-07-01,Receipt,Alpha Transport,0.0,7137.75,66153.75
2024-07-01,Receipt,Eagle Freight,0.0,6155.03,72308.78
2024-07-01,Payment,Engen,32250.0,0.0,40058.78
2024-07-01,Payment,Engen,38700.0,0.0,1358.7799999999988
2024-07-01,Payment,Engen,32750.0,0.0,-31391.22
2024-07-01,Payment,Engen,29500.0,0.0,-60891.22
2024-07-01,Payment,Engen,29500.0,0.0,-90391.22
2024-07-01,Payment,Engen,24600.0,0.0,-114991.22
2024-07-02,Payment,Engen,36900.0,0.0,-151891.22
2024-07-02,Payment,Engen,26400.0,0.0,-178291.22
2024-07-02,Payment,Engen,23400.0,0.0,-201691.22
2024-07-02,Payment,Engen,15750.0,0.0,-217441.22
2024-07-02,Payment,Engen,32100.0,0.0,-249541.22
2024-07-02,Receipt,Omega Cargo,0.0,7070.5,-242470.72
2024-07-02,Receipt,Cash Customer,0.0,22378.78,-220091.94
2024-07-02,Receipt,Cash Customer,0.0,18653.17,-201438.77000000002
2024-07-02,Receipt,Falcon Movers,0.0,9139.2,-192299.57
2024-07-02,Receipt,Omega Cargo,0.0,2920.0,-189379.57
2024-07-03,Receipt,Cash Customer,0.0,14126.4,-175253.17
2024-07-03,Receipt,Cash Customer,0.0,19567.24,-155685.93000000002
2024-07-03,Receipt,MaxDrive Ltd,0.0,11614.23,-144071.7
2024-07-03,Payment,Engen,16500.0,0.0,-160571.7
2024-07-03,Payment,Engen,36900.0,0.0,-197471.7
2024-07-03,Receipt,Delta Haulage,0.0,3084.48,-194387.22
2024-07-03,Payment,Engen,27500.0,0.0,-221887.22
2024-07-03,Payment,Engen,21000.0,0.0,-242887.22
2024-07-03,Payment,Engen,18450.0,0.0,-261337.22
2024-07-03,Payment,Engen,17550.0,0.0,-278887.22
2024-07-03,Payment,Engen,19650.0,0.0,-298537.22
2024-07-03,Payment,Engen,32250.0,0.0,-330787.22
2024-07-03,Receipt,Kappa Transporters,0.0,6734.63,-324052.58999999997
2024-07-03,Receipt,Civic Petroleum,0.0,8747.76,-315304.82999999996
2024-07-03,Receipt,Alpha Transport,0.0,2359.96,-312944.87
2024-07-03,Receipt,Ivy Fuels,0.0,7806.78,-305138.08999999997
2024-07-04,Payment,Engen,22200.0,0.0,-327338.08999999997
2024-07-04,Receipt,Cash Customer,0.0,25037.04,-302301.05
2024-07-04,Receipt,Cash Customer,0.0,15818.24,-286482.81
2024-07-04,Receipt,Ivy Fuels,0.0,11514.0,-274968.81
2024-07-04,Receipt,Giga Haulers,0.0,4302.69,-270666.12
2024-07-04,Receipt,Giga Haulers,0.0,6872.25,-263793.87
2024-07-04,Payment,Engen,22800.0,0.0,-286593.87
2024-07-04,Payment,Engen,24800.0,0.0,-311393.87
2024-07-05,Payment,Engen,25600.0,0.0,-336993.87
2024-07-05,Payment,Engen,16650.0,0.0,-353643.87
2024-07-05,Payment,Engen,36600.0,0.0,-390243.87
2024-07-05,Payment,Engen,16950.0,0.0,-407193.87
2024-07-05,Payment,Engen,25400.0,0.0,-432593.87
2024-07-05,Receipt,Helix Petroleum,0.0,9460.92,-423132.95
2024-07-05,Receipt,Cash Customer,0.0,16997.04,-406135.91000000003
2024-07-05,Receipt,Omega Cargo,0.0,8827.5,-397308.41000000003
2024-07-05,Receipt,Helix Petroleum,0.0,5530.2,-391778.21
2024-07-05,Receipt,Delta Haulage,0.0,9633.0,-382145.21
2024-07-05,Receipt,Helix Petroleum,0.0,2272.05,-379873.16000000003
2024-07-05,Receipt,Cash Customer,0.0,17113.55,-362759.61000000004
2024-07-06,Receipt,Ivy Fuels,0.0,6512.79,-356246.82000000007
2024-07-06,Payment,Engen,35400.0,0.0,-391646.82000000007
2024-07-06,Payment,Engen,24200.0,0.0,-415846.82000000007
2024-07-06,Payment,Engen,26600.0,0.0,-442446.82000000007
2024-07-06,Payment,Engen,39300.0,0.0,-481746.82000000007
2024-07-06,Payment,Engen,28750.0,0.0,-510496.82000000007
2024-07-06,Receipt,Cash Customer,0.0,19069.06,-491427.76000000007
2024-07-06,Receipt,Cash Customer,0.0,14120.79,-477306.9700000001
2024-07-06,Receipt,Eagle Freight,0.0,5976.0,-471330.9700000001
2024-07-06,Receipt,Kappa Transporters,0.0,7163.52,-464167.45000000007
2024-07-06,Receipt,Helix Petroleum,0.0,9470.24,-454697.2100000001
2024-07-06,Payment,Engen,19050.0,0.0,-473747.2100000001
2024-07-06,Receipt,Jupiter Energy,0.0,11377.85,-462369.3600000001
2024-07-07,Payment,Engen,23000.0,0.0,-485369.3600000001
2024-07-07,Payment,Engen,29000.0,0.0,-514369.3600000001
2024-07-07,Payment,Engen,24600.0,0.0,-538969.3600000001
2024-07-07,Payment,Engen,26200.0,0.0,-565169.3600000001
2024-07-07,Payment,Engen,22600.0,0.0,-587769.3600000001
2024-07-07,Payment,Engen,30000.0,0.0,-617769.3600000001
2024-07-07,Payment,Engen,31500.0,0.0,-649269.3600000001
2024-07-07,Payment,Engen,33000.0,0.0,-682269.3600000001
2024-07-07,Payment,Engen,36600.0,0.0,-718869.3600000001
2024-07-07,Receipt,Alpha Transport,0.0,12807.72,-706061.6400000001
2024-07-07,Receipt,Beta Logistics,0.0,10592.88,-695468.7600000001
2024-07-07,Receipt,Ivy Fuels,0.0,2120.9,-693347.8600000001
2024-07-07,Receipt,Delta Haulage,0.0,4919.46,-688428.4000000001
2024-07-07,Receipt,Kappa Transporters,0.0,3363.16,-685065.2400000001
2024-07-07,Receipt,Eagle Freight,0.0,9841.45,-675223.79
2024-07-07,Receipt,Cash Customer,0.0,25201.8,-650021.9900000001
2024-07-07,Receipt,Cash Customer,0.0,23020.6,-627001.3900000001
2024-07-08,Payment,Engen,18900.0,0.0,-645901.3900000001
2024-07-08,Receipt,MaxDrive Ltd,0.0,9613.06,-636288.3300000001
2024-07-08,Receipt,Nexus Fuels,0.0,3128.19,-633160.1400000001
2024-07-08,Receipt,Jupiter Energy,0.0,5444.64,-627715.5000000001
2024-07-08,Payment,Engen,16800.0,0.0,-644515.5000000001
2024-07-08,Receipt,Cash Customer,0.0,17376.84,-627138.6600000001
2024-07-08,Payment,Engen,18150.0,0.0,-645288.6600000001
2024-07-08,Payment,Engen,34800.0,0.0,-680088.6600000001
2024-07-08,Payment,Engen,27000.0,0.0,-707088.6600000001
2024-07-08,Payment,Engen,28250.0,0.0,-735338.6600000001
2024-07-08,Payment,Engen,37500.0,0.0,-772838.6600000001
2024-07-08,Payment,Engen,25200.0,0.0,-798038.6600000001
2024-07-08,Payment,Engen,35700.0,0.0,-833738.6600000001
2024-07-08,Receipt,MaxDrive Ltd,0.0,2603.84,-831134.8200000002
2024-07-08,Receipt,Cash Customer,0.0,18704.0,-812430.8200000002
2024-07-09,Receipt,Cash Customer,0.0,22408.11,-790022.7100000002
2024-07-09,Receipt,Nexus Fuels,0.0,7473.62,-782549.0900000002
2024-07-09,Receipt,Civic Petroleum,0.0,9748.44,-772800.6500000003
2024-07-09,Receipt,Ivy Fuels,0.0,2380.5,-770420.1500000003
2024-07-09,Receipt,Cash Customer,0.0,23886.44,-746533.7100000003
2024-07-09,Receipt,Nexus Fuels,0.0,5271.42,-741262.2900000003
2024-07-09,Receipt,Beta Logistics,0.0,10615.8,-730646.4900000002
2024-07-09,Payment,Engen,26600.0,0.0,-757246.4900000002
2024-07-09,Payment,Engen,25600.0,0.0,-782846.4900000002
2024-07-09,Payment,Engen,15900.0,0.0,-798746.4900000002
2024-07-09,Payment,Engen,26200.0,0.0,-824946.4900000002
2024-07-09,Payment,Engen,34500.0,0.0,-859446.4900000002
2024-07-09,Payment,Engen,36600.0,0.0,-896046.4900000002
2024-07-10,Receipt,Alpha Transport,0.0,6185.7,-889860.7900000003
2024-07-10,Receipt,Cash Customer,0.0,27033.51,-862827.2800000003
2024-07-10,Receipt,Cash Customer,0.0,26137.92,-836689.3600000002
2024-07-10,Payment,Engen,31800.0,0.0,-868489.3600000002
2024-07-10,Payment,Engen,18450.0,0.0,-886939.3600000002
2024-07-10,Payment,Engen,27250.0,0.0,-914189.3600000002
2024-07-10,Receipt,Helix Petroleum,0.0,2367.56,-911821.8000000002
2024-07-10,Payment,Engen,27500.0,0.0,-939321.8000000002
2024-07-10,Payment,Engen,24200.0,0.0,-963521.8000000002
2024-07-10,Receipt,Nexus Fuels,0.0,8124.75,-955397.0500000002
2024-07-11,Payment,Engen,37500.0,0.0,-992897.0500000002
2024-07-11,Receipt,Omega Cargo,0.0,1606.5,-991290.5500000002
2024-07-11,Receipt,Eagle Freight,0.0,7444.36,-983846.1900000002
2024-07-11,Receipt,Helix Petroleum,0.0,6592.43,-977253.7600000001
2024-07-11,Receipt,Cash Customer,0.0,22808.59,-954445.1700000002
2024-07-11,Receipt,Cash Customer,0.0,29831.94,-924613.2300000002
2024-07-11,Payment,Engen,26800.0,0.0,-951413.2300000002
2024-07-12,Receipt,Cash Customer,0.0,23478.4,-927934.8300000002
2024-07-12,Receipt,Cash Customer,0.0,16786.5,-911148.3300000002
2024-07-12,Receipt,Ivy Fuels,0.0,11530.08,-899618.2500000002
2024-07-12,Receipt,Beta Logistics,0.0,5736.96,-893881.2900000003
2024-07-12,Receipt,Nexus Fuels,0.0,9992.52,-883888.7700000003
2024-07-12,Receipt,Falcon Movers,0.0,7461.0,-876427.7700000003
2024-07-12,Receipt,Lumen Traders,0.0,10264.32,-866163.4500000003
2024-07-12,Receipt,Giga Haulers,0.0,3183.96,-862979.4900000003
2024-07-12,Payment,Engen,33000.0,0.0,-895979.4900000003
2024-07-12,Payment,Engen,29000.0,0.0,-924979.4900000003
2024-07-12,Payment,Engen,29250.0,0.0,-954229.4900000003
2024-07-12,Payment,Engen,23800.0,0.0,-978029.4900000003
2024-07-12,Payment,Engen,37500.0,0.0,-1015529.4900000003
2024-07-12,Payment,Engen,30500.0,0.0,-1046029.4900000003
2024-07-12,Payment,Engen,23200.0,0.0,-1069229.4900000002
2024-07-12,Payment,Engen,27000.0,0.0,-1096229.4900000002
2024-07-12,Payment,Engen,34500.0,0.0,-1130729.4900000002
2024-07-13,Receipt,Cash Customer,0.0,27753.14,-1102976.3500000003
2024-07-13,Payment,Engen,32700.0,0.0,-1135676.3500000003
2024-07-13,Payment,Engen,15900.0,0.0,-1151576.3500000003
2024-07-13,Payment,Engen,38700.0,0.0,-1190276.3500000003
2024-07-13,Receipt,MaxDrive Ltd,0.0,9574.74,-1180701.6100000003
2024-07-13,Receipt,Cash Customer,0.0,14071.2,-1166630.4100000004
2024-07-13,Receipt,MaxDrive Ltd,0.0,2541.94,-1164088.4700000004
2024-07-13,Receipt,Jupiter Energy,0.0,4904.64,-1159183.8300000005
2024-07-14,Payment,Engen,36900.0,0.0,-1196083.8300000005
2024-07-14,Payment,Engen,19800.0,0.0,-1215883.8300000005
2024-07-14,Payment,Engen,30000.0,0.0,-1245883.8300000005
2024-07-14,Payment,Engen,32250.0,0.0,-1278133.8300000005
2024-07-14,Payment,Engen,30000.0,0.0,-1308133.8300000005
2024-07-14,Receipt,Cash Customer,0.0,23598.12,-1284535.7100000004
2024-07-14,Receipt,Cash Customer,0.0,17742.08,-1266793.6300000004
2024-07-14,Receipt,Civic Petroleum,0.0,10947.08,-1255846.5500000005
2024-07-14,Receipt,Jupiter Energy,0.0,3067.66,-1252778.8900000006
2024-07-14,Receipt,Lumen Traders,0.0,3766.5,-1249012.3900000006
2024-07-15,Receipt,Jupiter Energy,0.0,7768.86,-1241243.5300000005
2024-07-15,Payment,Engen,31250.0,0.0,-1272493.5300000005
2024-07-15,Payment,Engen,19200.0,0.0,-1291693.5300000005
2024-07-15,Payment,Engen,23600.0,0.0,-1315293.5300000005
2024-07-15,Receipt,Cash Customer,0.0,16289.4,-1299004.1300000004
2024-07-15,Payment,Engen,34200.0,0.0,-1333204.1300000004
2024-07-15,Receipt,Jupiter Energy,0.0,11126.43,-1322077.7000000004
2024-07-15,Receipt,Alpha Transport,0.0,6526.52,-1315551.1800000004
2024-07-15,Receipt,Civic Petroleum,0.0,6326.54,-1309224.6400000004
2024-07-15,Receipt,Cash Customer,0.0,29651.02,-1279573.6200000003
2024-07-16,Payment,Engen,25200.0,0.0,-1304773.6200000003
2024-07-16,Payment,Engen,23000.0,0.0,-1327773.6200000003
2024-07-16,Payment,Engen,32500.0,0.0,-1360273.6200000003
2024-07-16,Payment,Engen,18150.0,0.0,-1378423.6200000003
2024-07-16,Payment,Engen,32500.0,0.0,-1410923.6200000003
2024-07-16,Payment,Engen,29750.0,0.0,-1440673.6200000003
2024-07-16,Payment,Engen,23400.0,0.0,-1464073.6200000003
2024-07-16,Payment,Engen,23600.0,0.0,-1487673.6200000003
2024-07-16,Receipt,Omega Cargo,0.0,12307.14,-1475366.4800000004
2024-07-16,Receipt,Nexus Fuels,0.0,1955.8,-1473410.6800000004
2024-07-16,Receipt,Helix Petroleum,0.0,8077.0,-1465333.6800000004
2024-07-16,Receipt,Cash Customer,0.0,20777.6,-1444556.0800000003
2024-07-16,Receipt,Cash Customer,0.0,18374.4,-1426181.6800000004
2024-07-16,Payment,Engen,19650.0,0.0,-1445831.6800000004
2024-07-17,Receipt,Kappa Transporters,0.0,3042.65,-1442789.0300000005
2024-07-17,Receipt,Falcon Movers,0.0,11213.96,-1431575.0700000005
2024-07-17,Receipt,Giga Haulers,0.0,5279.3,-1426295.7700000005
2024-07-17,Receipt,Lumen Traders,0.0,7497.15,-1418798.6200000006
2024-07-17,Receipt,Cash Customer,0.0,14163.07,-1404635.5500000005
2024-07-17,Receipt,Cash Customer,0.0,28921.2,-1375714.3500000006
2024-07-17,Receipt,Lumen Traders,0.0,8843.52,-1366870.8300000005
2024-07-17,Payment,Engen,24200.0,0.0,-1391070.8300000005
2024-07-17,Payment,Engen,19200.0,0.0,-1410270.8300000005
2024-07-17,Payment,Engen,34500.0,0.0,-1444770.8300000005
2024-07-18,Receipt,Cash Customer,0.0,25764.2,-1419006.6300000006
2024-07-18,Payment,Engen,17850.0,0.0,-1436856.6300000006
2024-07-18,Payment,Engen,40200.0,0.0,-1477056.6300000006
2024-07-18,Payment,Engen,22400.0,0.0,-1499456.6300000006
2024-07-18,Payment,Engen,23800.0,0.0,-1523256.6300000006
2024-07-18,Receipt,Cash Customer,0.0,16212.7,-1507043.9300000006
2024-07-18,Receipt,Lumen Traders,0.0,4879.2,-1502164.7300000007
2024-07-18,Receipt,Jupiter Energy,0.0,5044.5,-1497120.2300000007
2024-07-18,Receipt,Jupiter Energy,0.0,9542.46,-1487577.7700000007
2024-07-18,Receipt,Lumen Traders,0.0,4560.12,-1483017.6500000006
2024-07-18,Receipt,Civic Petroleum,0.0,4813.88,-1478203.7700000007
2024-07-18,Payment,Engen,17550.0,0.0,-1495753.7700000007
2024-07-19,Receipt,Cash Customer,0.0,22788.15,-1472965.6200000008
2024-07-19,Receipt,Helix Petroleum,0.0,9766.35,-1463199.2700000007
2024-07-19,Payment,Engen,34800.0,0.0,-1497999.2700000007
2024-07-19,Receipt,Giga Haulers,0.0,2450.73,-1495548.5400000007
2024-07-19,Receipt,Delta Haulage,0.0,6430.84,-1489117.7000000007
2024-07-19,Payment,Engen,23800.0,0.0,-1512917.7000000007
2024-07-19,Payment,Engen,33750.0,0.0,-1546667.7000000007
2024-07-19,Payment,Engen,29250.0,0.0,-1575917.7000000007
2024-07-19,Receipt,Falcon Movers,0.0,3844.2,-1572073.5000000007
2024-07-19,Receipt,Eagle Freight,0.0,9590.4,-1562483.1000000008
2024-07-19,Receipt,Eagle Freight,0.0,11451.96,-1551031.1400000008
2024-07-19,Receipt,Cash Customer,0.0,18085.62,-1532945.5200000007
2024-07-19,Payment,Engen,25400.0,0.0,-1558345.5200000007
2024-07-20,Payment,Engen,26200.0,0.0,-1584545.5200000007
2024-07-20,Payment,Engen,26200.0,0.0,-1610745.5200000007
2024-07-20,Payment,Engen,18450.0,0.0,-1629195.5200000007
2024-07-20,Payment,Engen,37800.0,0.0,-1666995.5200000007
2024-07-20,Payment,Engen,34200.0,0.0,-1701195.5200000007
2024-07-20,Payment,Engen,26400.0,0.0,-1727595.5200000007
2024-07-20,Receipt,Cash Customer,0.0,16024.95,-1711570.5700000008
2024-07-20,Receipt,Cash Customer,0.0,26579.5,-1684991.0700000008
2024-07-20,Receipt,Jupiter Energy,0.0,6674.8,-1678316.2700000007
2024-07-20,Receipt,Civic Petroleum,0.0,6175.47,-1672140.8000000007
2024-07-20,Receipt,MaxDrive Ltd,0.0,8836.5,-1663304.3000000007
2024-07-20,Payment,Engen,19200.0,0.0,-1682504.3000000007
2024-07-21,Receipt,Cash Customer,0.0,27629.43,-1654874.8700000008
2024-07-21,Payment,Engen,17100.0,0.0,-1671974.8700000008
2024-07-21,Payment,Engen,31500.0,0.0,-1703474.8700000008
2024-07-21,Payment,Engen,25000.0,0.0,-1728474.8700000008
2024-07-21,Receipt,Delta Haulage,0.0,2360.34,-1726114.5300000007
2024-07-21,Receipt,Civic Petroleum,0.0,4573.79,-1721540.7400000007
2024-07-21,Receipt,MaxDrive Ltd,0.0,6980.3,-1714560.4400000006
2024-07-21,Receipt,Nexus Fuels,0.0,4030.65,-1710529.7900000007
2024-07-21,Receipt,MaxDrive Ltd,0.0,2967.93,-1707561.8600000008
2024-07-21,Receipt,Cash Customer,0.0,18982.87,-1688578.9900000007
2024-07-22,Receipt,Eagle Freight,0.0,2089.78,-1686489.2100000007
2024-07-22,Payment,Engen,18150.0,0.0,-1704639.2100000007
2024-07-22,Payment,Engen,38400.0,0.0,-1743039.2100000007
2024-07-22,Payment,Engen,30750.0,0.0,-1773789.2100000007
2024-07-22,Payment,Engen,19650.0,0.0,-1793439.2100000007
2024-07-22,Receipt,Delta Haulage,0.0,10980.0,-1782459.2100000007
2024-07-22,Payment,Engen,17550.0,0.0,-1800009.2100000007
2024-07-22,Receipt,Helix Petroleum,0.0,10319.53,-1789689.6800000006
2024-07-22,Receipt,Civic Petroleum,0.0,7571.78,-1782117.9000000006
2024-07-22,Receipt,Cash Customer,0.0,23271.6,-1758846.3000000005
2024-07-22,Receipt,Beta Logistics,0.0,5113.31,-1753732.9900000005
2024-07-22,Receipt,Cash Customer,0.0,25312.98,-1728420.0100000005
2024-07-23,Receipt,Nexus Fuels,0.0,11501.28,-1716918.7300000004
2024-07-23,Payment,Engen,31000.0,0.0,-1747918.7300000004
2024-07-23,Receipt,Eagle Freight,0.0,1963.84,-1745954.8900000004
2024-07-23,Payment,Engen,23200.0,0.0,-1769154.8900000004
2024-07-23,Receipt,Cash Customer,0.0,27680.31,-1741474.5800000003
2024-07-23,Receipt,Cash Customer,0.0,24292.06,-1717182.5200000003
2024-07-23,Receipt,MaxDrive Ltd,0.0,7348.68,-1709833.8400000003
2024-07-23,Payment,Engen,16350.0,0.0,-1726183.8400000003
2024-07-23,Receipt,Delta Haulage,0.0,10955.88,-1715227.9600000004
2024-07-23,Receipt,Alpha Transport,0.0,2833.62,-1712394.3400000003
2024-07-24,Payment,Engen,32750.0,0.0,-1745144.3400000003
2024-07-24,Receipt,Omega Cargo,0.0,9609.72,-1735534.6200000003
2024-07-24,Payment,Engen,16950.0,0.0,-1752484.6200000003
2024-07-24,Payment,Engen,24800.0,0.0,-1777284.6200000003
2024-07-24,Payment,Engen,18900.0,0.0,-1796184.6200000003
2024-07-24,Payment,Engen,29750.0,0.0,-1825934.6200000003
2024-07-24,Receipt,Giga Haulers,0.0,2699.62,-1823235.0000000002
2024-07-24,Payment,Engen,23400.0,0.0,-1846635.0000000002
2024-07-24,Receipt,MaxDrive Ltd,0.0,6552.72,-1840082.2800000003
2024-07-24,Receipt,Cash Customer,0.0,23857.88,-1816224.4000000004
2024-07-24,Receipt,Cash Customer,0.0,14811.16,-1801413.2400000005
2024-07-24,Receipt,Ivy Fuels,0.0,9875.46,-1791537.7800000005
2024-07-24,Receipt,Lumen Traders,0.0,7845.19,-1783692.5900000005
2024-07-24,Payment,Engen,32000.0,0.0,-1815692.5900000005
2024-07-24,Receipt,Helix Petroleum,0.0,3050.2,-1812642.3900000006
2024-07-25,Receipt,Cash Customer,0.0,16492.5,-1796149.8900000006
2024-07-25,Receipt,Cash Customer,0.0,26560.8,-1769589.0900000005
2024-07-25,Receipt,Giga Haulers,0.0,9407.8,-1760181.2900000005
2024-07-25,Payment,Engen,24800.0,0.0,-1784981.2900000005
2024-07-25,Receipt,Lumen Traders,0.0,2915.1,-1782066.1900000004
2024-07-25,Payment,Engen,27750.0,0.0,-1809816.1900000004
2024-07-25,Receipt,MaxDrive Ltd,0.0,4711.35,-1805104.8400000003
2024-07-25,Receipt,Civic Petroleum,0.0,10520.64,-1794584.2000000004
2024-07-25,Receipt,Lumen Traders,0.0,8433.18,-1786151.0200000005
2024-07-25,Receipt,Kappa Transporters,0.0,10990.48,-1775160.5400000005
2024-07-25,Payment,Engen,35700.0,0.0,-1810860.5400000005
2024-07-25,Payment,Engen,35100.0,0.0,-1845960.5400000005
2024-07-25,Payment,Engen,27250.0,0.0,-1873210.5400000005
2024-07-25,Payment,Engen,35400.0,0.0,-1908610.5400000005
2024-07-25,Payment,Engen,17850.0,0.0,-1926460.5400000005
2024-07-26,Receipt,Cash Customer,0.0,24901.77,-1901558.7700000005
2024-07-26,Receipt,Cash Customer,0.0,23272.11,-1878286.6600000004
2024-07-26,Receipt,Omega Cargo,0.0,5604.75,-1872681.9100000004
2024-07-26,Receipt,Eagle Freight,0.0,5436.04,-1867245.8700000003
2024-07-26,Receipt,MaxDrive Ltd,0.0,4399.37,-1862846.5000000002
2024-07-26,Receipt,Beta Logistics,0.0,5235.0,-1857611.5000000002
2024-07-26,Payment,Engen,24400.0,0.0,-1882011.5000000002
2024-07-26,Payment,Engen,35400.0,0.0,-1917411.5000000002
2024-07-27,Payment,Engen,17250.0,0.0,-1934661.5000000002
2024-07-27,Receipt,Helix Petroleum,0.0,6744.72,-1927916.7800000003
2024-07-27,Receipt,Cash Customer,0.0,19044.1,-1908872.6800000002
2024-07-27,Receipt,Cash Customer,0.0,28600.29,-1880272.3900000001
2024-07-27,Receipt,Kappa Transporters,0.0,4341.84,-1875930.55
2024-07-27,Payment,Engen,37800.0,0.0,-1913730.55
2024-07-27,Receipt,Omega Cargo,0.0,7095.27,-1906635.28
2024-07-27,Payment,Engen,16500.0,0.0,-1923135.28
2024-07-27,Payment,Engen,34800.0,0.0,-1957935.28
2024-07-27,Payment,Engen,29000.0,0.0,-1986935.28
2024-07-28,Receipt,Nexus Fuels,0.0,3275.34,-1983659.94
2024-07-28,Receipt,Kappa Transporters,0.0,10366.4,-1973293.54
2024-07-28,Receipt,Giga Haulers,0.0,1931.3,-1971362.24
2024-07-28,Receipt,Cash Customer,0.0,15256.24,-1956106.0
2024-07-28,Payment,Engen,19050.0,0.0,-1975156.0
2024-07-28,Payment,Engen,27750.0,0.0,-2002906.0
2024-07-28,Receipt,Cash Customer,0.0,21533.82,-1981372.18
2024-07-28,Payment,Engen,19950.0,0.0,-2001322.18
2024-07-28,Payment,Engen,25000.0,0.0,-2026322.18
2024-07-28,Payment,Engen,34200.0,0.0,-2060522.18
2024-07-28,Payment,Engen,17850.0,0.0,-2078372.18
2024-07-29,Receipt,Ivy Fuels,0.0,3681.8,-2074690.38
2024-07-29,Receipt,Giga Haulers,0.0,9926.74,-2064763.64
2024-07-29,Payment,Engen,40500.0,0.0,-2105263.6399999997
2024-07-29,Receipt,Civic Petroleum,0.0,9196.4,-2096067.24
2024-07-29,Receipt,Ivy Fuels,0.0,3707.05,-2092360.19
2024-07-29,Receipt,Beta Logistics,0.0,9123.84,-2083236.3499999999
2024-07-29,Receipt,Cash Customer,0.0,17167.16,-2066069.19
2024-07-29,Receipt,Cash Customer,0.0,22276.8,-2043792.39
2024-07-29,Payment,Engen,27750.0,0.0,-2071542.39
2024-07-29,Payment,Engen,16800.0,0.0,-2088342.39
2024-07-29,Payment,Engen,27000.0,0.0,-2115342.3899999997
2024-07-29,Payment,Engen,28750.0,0.0,-2144092.3899999997
2024-07-30,Receipt,Alpha Transport,0.0,9451.2,-2134641.19
2024-07-30,Receipt,Alpha Transport,0.0,5121.1,-2129520.09
2024-07-30,Receipt,Eagle Freight,0.0,2645.76,-2126874.33
2024-07-30,Payment,Engen,39600.0,0.0,-2166474.33
2024-07-30,Payment,Engen,17100.0,0.0,-2183574.33
2024-07-30,Payment,Engen,16950.0,0.0,-2200524.33
2024-07-30,Receipt,Cash Customer,0.0,29209.28,-2171315.0500000003
2024-07-30,Payment,Engen,22600.0,0.0,-2193915.0500000003
2024-07-30,Receipt,Helix Petroleum,0.0,7912.4,-2186002.6500000004
2024-07-30,Receipt,Falcon Movers,0.0,10428.76,-2175573.8900000006
2024-07-30,Receipt,Cash Customer,0.0,26233.87,-2149340.0200000005
2024-07-30,Payment,Engen,17400.0,0.0,-2166740.0200000005
2024-07-30,Payment,Engen,39000.0,0.0,-2205740.0200000005
2024-07-31,Payment,Engen,18600.0,0.0,-2224340.0200000005
2024-07-31,Receipt,Cash Customer,0.0,30786.1,-2193553.9200000004
2024-07-31,Receipt,Lumen Traders,0.0,9049.56,-2184504.3600000003
2024-07-31,Receipt,Omega Cargo,0.0,7337.52,-2177166.8400000003
2024-07-31,Payment,Engen,17550.0,0.0,-2194716.8400000003
2024-07-31,Payment,Engen,23400.0,0.0,-2218116.8400000003
2024-07-31,Payment,Engen,22800.0,0.0,-2240916.8400000003
2024-07-31,Payment,Engen,28250.0,0.0,-2269166.8400000003
2024-07-31,Receipt,Cash Customer,0.0,16758.04,-2252408.8000000003
2024-07-31,Payment,Engen,18300.0,0.0,-2270708.8000000003
2024-07-31,Payment,Engen,35700.0,0.0,-2306408.8000000003
2024-07-31,Receipt,MaxDrive Ltd,0.0,6082.58,-2300326.22
2024-07-31,Receipt,Falcon Movers,0.0,10257.8,-2290068.4200000004
2024-07-31,Receipt,Alpha Transport,0.0,4419.2,-2285649.22
2024-08-01,Payment,Engen,23200.0,0.0,-2308849.22
2024-08-01,Payment,Engen,19050.0,0.0,-2327899.22
2024-08-01,Payment,Engen,36900.0,0.0,-2364799.22
2024-08-01,Payment,Engen,39900.0,0.0,-2404699.22
2024-08-01,Payment,Engen,31250.0,0.0,-2435949.22
2024-08-01,Payment,Engen,16950.0,0.0,-2452899.22
2024-08-01,Receipt,Cash Customer,0.0,27136.53,-2425762.6900000004
2024-08-01,Receipt,Delta Haulage,0.0,3834.6,-2421928.0900000003
2024-08-01,Receipt,Civic Petroleum,0.0,3759.84,-2418168.2500000005
2024-08-01,Receipt,Lumen Traders,0.0,7964.97,-2410203.2800000003
2024-08-01,Receipt,Lumen Traders,0.0,11473.41,-2398729.87
2024-08-01,Receipt,Beta Logistics,0.0,3166.8,-2395563.0700000003
2024-08-01,Receipt,Beta Logistics,0.0,3992.04,-2391571.0300000003
2024-08-01,Receipt,Cash Customer,0.0,25709.99,-2365861.04
2024-08-02,Payment,Engen,28750.0,0.0,-2394611.04
2024-08-02,Payment,Engen,18750.0,0.0,-2413361.04
2024-08-02,Payment,Engen,32000.0,0.0,-2445361.04
2024-08-02,Payment,Engen,16800.0,0.0,-2462161.04
2024-08-02,Payment,Engen,18600.0,0.0,-2480761.04
2024-08-02,Receipt,Jupiter Energy,0.0,8204.2,-2472556.84
2024-08-02,Payment,Engen,30000.0,0.0,-2502556.84
2024-08-02,Receipt,Falcon Movers,0.0,6512.64,-2496044.1999999997
2024-08-02,Receipt,Jupiter Energy,0.0,2881.48,-2493162.7199999997
2024-08-02,Receipt,Cash Customer,0.0,29129.36,-2464033.36
2024-08-02,Receipt,Giga Haulers,0.0,8524.16,-2455509.1999999997
2024-08-02,Receipt,MaxDrive Ltd,0.0,4811.76,-2450697.44
2024-08-02,Receipt,Ivy Fuels,0.0,4779.72,-2445917.7199999997
2024-08-02,Receipt,Cash Customer,0.0,27337.5,-2418580.2199999997
2024-08-03,Payment,Engen,32700.0,0.0,-2451280.2199999997
2024-08-03,Payment,Engen,30500.0,0.0,-2481780.2199999997
2024-08-03,Receipt,Cash Customer,0.0,18775.04,-2463005.1799999997
2024-08-03,Receipt,Jupiter Energy,0.0,4890.84,-2458114.34
2024-08-03,Receipt,Delta Haulage,0.0,2524.34,-2455590.0
2024-08-03,Receipt,Alpha Transport,0.0,10805.05,-2444784.95
2024-08-03,Receipt,Delta Haulage,0.0,11753.46,-2433031.49
2024-08-03,Receipt,Delta Haulage,0.0,6575.96,-2426455.5300000003
2024-08-03,Receipt,Cash Customer,0.0,23573.55,-2402881.9800000004
2024-08-04,Payment,Engen,21800.0,0.0,-2424681.9800000004
2024-08-04,Payment,Engen,28000.0,0.0,-2452681.9800000004
2024-08-04,Payment,Engen,16050.0,0.0,-2468731.9800000004
2024-08-04,Payment,Engen,33500.0,0.0,-2502231.9800000004
2024-08-04,Receipt,Cash Customer,0.0,26742.96,-2475489.0200000005
2024-08-04,Payment,Engen,24000.0,0.0,-2499489.0200000005
2024-08-04,Payment,Engen,39900.0,0.0,-2539389.0200000005
2024-08-04,Receipt,Ivy Fuels,0.0,6213.76,-2533175.2600000007
2024-08-04,Receipt,Ivy Fuels,0.0,9876.96,-2523298.3000000007
2024-08-04,Receipt,Giga Haulers,0.0,12475.2,-2510823.1000000006
2024-08-04,Receipt,Falcon Movers,0.0,10505.35,-2500317.7500000005
2024-08-04,Receipt,Jupiter Energy,0.0,4513.5,-2495804.2500000005
2024-08-04,Receipt,Alpha Transport,0.0,7872.09,-2487932.1600000006
2024-08-04,Receipt,Cash Customer,0.0,18135.07,-2469797.090000001
2024-08-04,Payment,Engen,29750.0,0.0,-2499547.090000001
2024-08-05,Payment,Engen,30000.0,0.0,-2529547.090000001
2024-08-05,Payment,Engen,17100.0,0.0,-2546647.090000001
2024-08-05,Receipt,Giga Haulers,0.0,3336.0,-2543311.090000001
2024-08-05,Payment,Engen,39000.0,0.0,-2582311.090000001
2024-08-05,Receipt,Cash Customer,0.0,19680.0,-2562631.090000001
2024-08-05,Receipt,Cash Customer,0.0,19241.74,-2543389.3500000006
2024-08-05,Payment,Engen,25200.0,0.0,-2568589.3500000006
2024-08-05,Receipt,Ivy Fuels,0.0,2862.16,-2565727.1900000004
2024-08-05,Receipt,Falcon Movers,0.0,8517.4,-2557209.7900000005
2024-08-05,Payment,Engen,37200.0,0.0,-2594409.7900000005
2024-08-05,Payment,Engen,22600.0,0.0,-2617009.7900000005
2024-08-05,Payment,Engen,29250.0,0.0,-2646259.7900000005
2024-08-05,Payment,Engen,19050.0,0.0,-2665309.7900000005
2024-08-05,Payment,Engen,16800.0,0.0,-2682109.7900000005
2024-08-05,Payment,Engen,17850.0,0.0,-2699959.7900000005
2024-08-06,Payment,Engen,16950.0,0.0,-2716909.7900000005
2024-08-06,Payment,Engen,26750.0,0.0,-2743659.7900000005
2024-08-06,Payment,Engen,33600.0,0.0,-2777259.7900000005
2024-08-06,Payment,Engen,15900.0,0.0,-2793159.7900000005
2024-08-06,Payment,Engen,27000.0,0.0,-2820159.7900000005
2024-08-06,Payment,Engen,17100.0,0.0,-2837259.7900000005
2024-08-06,Payment,Engen,35100.0,0.0,-2872359.7900000005
2024-08-06,Receipt,Cash Customer,0.0,28198.65,-2844161.1400000006
2024-08-06,Payment,Engen,37200.0,0.0,-2881361.1400000006
2024-08-06,Receipt,Alpha Transport,0.0,3318.7,-2878042.4400000004
2024-08-06,Receipt,Delta Haulage,0.0,7086.44,-2870956.0000000005
2024-08-06,Receipt,Jupiter Energy,0.0,10524.28,-2860431.7200000007
2024-08-06,Receipt,Nexus Fuels,0.0,11302.56,-2849129.1600000006
2024-08-06,Receipt,Cash Customer,0.0,25541.04,-2823588.1200000006
2024-08-07,Payment,Engen,31500.0,0.0,-2855088.1200000006
2024-08-07,Payment,Engen,25600.0,0.0,-2880688.1200000006
2024-08-07,Payment,Engen,24000.0,0.0,-2904688.1200000006
2024-08-07,Payment,Engen,27750.0,0.0,-2932438.1200000006
2024-08-07,Receipt,Beta Logistics,0.0,5878.32,-2926559.8000000007
2024-08-07,Payment,Engen,19650.0,0.0,-2946209.8000000007
2024-08-07,Receipt,Ivy Fuels,0.0,3960.6,-2942249.2000000007
2024-08-07,Receipt,Cash Customer,0.0,23170.32,-2919078.880000001
2024-08-07,Receipt,Civic Petroleum,0.0,8851.53,-2910227.350000001
2024-08-07,Receipt,Lumen Traders,0.0,7351.47,-2902875.880000001
2024-08-07,Payment,Engen,23200.0,0.0,-2926075.880000001
2024-08-07,Receipt,Cash Customer,0.0,21230.75,-2904845.130000001
2024-08-08,Receipt,Helix Petroleum,0.0,11486.58,-2893358.5500000007
2024-08-08,Receipt,Giga Haulers,0.0,11019.83,-2882338.7200000007
2024-08-08,Payment,Engen,31750.0,0.0,-2914088.7200000007
2024-08-08,Receipt,Cash Customer,0.0,17952.39,-2896136.3300000005
2024-08-08,Receipt,Omega Cargo,0.0,4915.82,-2891220.5100000007
2024-08-08,Receipt,Cash Customer,0.0,27845.67,-2863374.840000001
2024-08-08,Receipt,Kappa Transporters,0.0,7295.85,-2856078.9900000007
2024-08-08,Receipt,Delta Haulage,0.0,3586.7,-2852492.2900000005
2024-08-09,Receipt,Alpha Transport,0.0,4077.45,-2848414.8400000003
2024-08-09,Receipt,Helix Petroleum,0.0,5613.74,-2842801.1
2024-08-09,Receipt,Helix Petroleum,0.0,7169.48,-2835631.62
2024-08-09,Receipt,Jupiter Energy,0.0,6550.44,-2829081.18
2024-08-09,Receipt,Cash Customer,0.0,23707.84,-2805373.3400000003
2024-08-09,Receipt,Cash Customer,0.0,19151.6,-2786221.74
2024-08-09,Payment,Engen,18600.0,0.0,-2804821.74
2024-08-09,Payment,Engen,23800.0,0.0,-2828621.74
2024-08-09,Payment,Engen,31500.0,0.0,-2860121.74
2024-08-09,Payment,Engen,23200.0,0.0,-2883321.74
2024-08-09,Payment,Engen,31800.0,0.0,-2915121.74
2024-08-10,Receipt,Cash Customer,0.0,29328.12,-2885793.62
2024-08-10,Receipt,Lumen Traders,0.0,6958.32,-2878835.3000000003
2024-08-10,Receipt,Omega Cargo,0.0,11004.0,-2867831.3000000003
2024-08-10,Receipt,Alpha Transport,0.0,5038.13,-2862793.1700000004
2024-08-10,Receipt,Alpha Transport,0.0,12454.81,-2850338.3600000003
2024-08-10,Receipt,Kappa Transporters,0.0,3974.04,-2846364.3200000003
2024-08-10,Payment,Engen,32250.0,0.0,-2878614.3200000003
2024-08-10,Receipt,Lumen Traders,0.0,2437.05,-2876177.2700000005
2024-08-10,Payment,Engen,17100.0,0.0,-2893277.2700000005
2024-08-10,Receipt,Cash Customer,0.0,20212.96,-2873064.3100000005
2024-08-10,Payment,Engen,18450.0,0.0,-2891514.3100000005
2024-08-11,Payment,Engen,18900.0,0.0,-2910414.3100000005
2024-08-11,Payment,Engen,23200.0,0.0,-2933614.3100000005
2024-08-11,Receipt,Cash Customer,0.0,27686.4,-2905927.9100000006
2024-08-11,Receipt,Ivy Fuels,0.0,7690.34,-2898237.5700000008
2024-08-11,Receipt,Giga Haulers,0.0,3606.76,-2894630.810000001
2024-08-11,Payment,Engen,22200.0,0.0,-2916830.810000001
2024-08-11,Receipt,Civic Petroleum,0.0,3132.15,-2913698.660000001
2024-08-11,Receipt,Cash Customer,0.0,22450.42,-2891248.240000001
2024-08-11,Payment,Engen,16350.0,0.0,-2907598.240000001
2024-08-11,Payment,Engen,30250.0,0.0,-2937848.240000001
2024-08-11,Payment,Engen,26200.0,0.0,-2964048.240000001
2024-08-11,Payment,Engen,33500.0,0.0,-2997548.240000001
2024-08-11,Payment,Engen,29500.0,0.0,-3027048.240000001
2024-08-11,Payment,Engen,19500.0,0.0,-3046548.240000001
2024-08-11,Payment,Engen,34800.0,0.0,-3081348.240000001
2024-08-12,Receipt,Kappa Transporters,0.0,10894.5,-3070453.740000001
2024-08-12,Receipt,MaxDrive Ltd,0.0,1821.25,-3068632.490000001
2024-08-12,Receipt,Beta Logistics,0.0,1772.53,-3066859.9600000014
2024-08-12,Receipt,Cash Customer,0.0,24643.97,-3042215.990000001
2024-08-12,Receipt,Cash Customer,0.0,20342.97,-3021873.020000001
2024-08-12,Payment,Engen,38400.0,0.0,-3060273.020000001
2024-08-12,Payment,Engen,32000.0,0.0,-3092273.020000001
2024-08-12,Payment,Engen,23800.0,0.0,-3116073.020000001
2024-08-12,Payment,Engen,30500.0,0.0,-3146573.020000001
2024-08-12,Payment,Engen,17550.0,0.0,-3164123.020000001
2024-08-12,Payment,Engen,18450.0,0.0,-3182573.020000001
2024-08-12,Payment,Engen,25400.0,0.0,-3207973.020000001
2024-08-12,Payment,Engen,37800.0,0.0,-3245773.020000001
2024-08-12,Receipt,Jupiter Energy,0.0,1783.52,-3243989.500000001
2024-08-13,Payment,Engen,30500.0,0.0,-3274489.500000001
2024-08-13,Payment,Engen,37500.0,0.0,-3311989.500000001
2024-08-13,Payment,Engen,31000.0,0.0,-3342989.500000001
2024-08-13,Payment,Engen,32500.0,0.0,-3375489.500000001
2024-08-13,Receipt,Cash Customer,0.0,16354.5,-3359135.000000001
2024-08-13,Receipt,Cash Customer,0.0,24676.0,-3334459.000000001
2024-08-13,Receipt,Helix Petroleum,0.0,5378.32,-3329080.680000001
2024-08-13,Receipt,Alpha Transport,0.0,3833.15,-3325247.530000001
2024-08-13,Payment,Engen,28000.0,0.0,-3353247.530000001
2024-08-13,Payment,Engen,19950.0,0.0,-3373197.530000001
2024-08-13,Receipt,Lumen Traders,0.0,3993.1,-3369204.430000001
2024-08-13,Receipt,Helix Petroleum,0.0,10241.35,-3358963.080000001
2024-08-14,Payment,Engen,38700.0,0.0,-3397663.080000001
2024-08-14,Payment,Engen,26000.0,0.0,-3423663.080000001
2024-08-14,Receipt,MaxDrive Ltd,0.0,4418.64,-3419244.440000001
2024-08-14,Receipt,Cash Customer,0.0,15517.88,-3403726.560000001
2024-08-14,Receipt,Delta Haulage,0.0,2184.6,-3401541.960000001
2024-08-14,Receipt,Helix Petroleum,0.0,7972.02,-3393569.940000001
2024-08-14,Payment,Engen,26750.0,0.0,-3420319.940000001
2024-08-14,Payment,Engen,23000.0,0.0,-3443319.940000001
2024-08-14,Payment,Engen,38100.0,0.0,-3481419.940000001
2024-08-14,Payment,Engen,33250.0,0.0,-3514669.940000001
2024-08-14,Receipt,Cash Customer,0.0,20149.74,-3494520.2000000007
2024-08-14,Receipt,Omega Cargo,0.0,5215.41,-3489304.7900000005
2024-08-15,Payment,Engen,24000.0,0.0,-3513304.7900000005
2024-08-15,Receipt,Cash Customer,0.0,17575.92,-3495728.8700000006
2024-08-15,Receipt,Giga Haulers,0.0,8752.51,-3486976.360000001
2024-08-15,Receipt,Lumen Traders,0.0,5852.25,-3481124.110000001
2024-08-15,Receipt,Kappa Transporters,0.0,6150.0,-3474974.110000001
2024-08-15,Receipt,Civic Petroleum,0.0,5690.8,-3469283.310000001
2024-08-15,Payment,Engen,21000.0,0.0,-3490283.310000001
2024-08-15,Payment,Engen,26600.0,0.0,-3516883.310000001
2024-08-15,Payment,Engen,28500.0,0.0,-3545383.310000001
2024-08-15,Payment,Engen,17100.0,0.0,-3562483.310000001
2024-08-15,Payment,Engen,22000.0,0.0,-3584483.310000001
2024-08-15,Payment,Engen,36600.0,0.0,-3621083.310000001
2024-08-15,Payment,Engen,18300.0,0.0,-3639383.310000001
2024-08-15,Receipt,Cash Customer,0.0,19299.28,-3620084.030000001
2024-08-16,Payment,Engen,26750.0,0.0,-3646834.030000001
2024-08-16,Payment,Engen,19200.0,0.0,-3666034.030000001
2024-08-16,Payment,Engen,18150.0,0.0,-3684184.030000001
2024-08-16,Payment,Engen,18900.0,0.0,-3703084.030000001
2024-08-16,Payment,Engen,25000.0,0.0,-3728084.030000001
2024-08-16,Receipt,Beta Logistics,0.0,4367.73,-3723716.300000001
2024-08-16,Receipt,Beta Logistics,0.0,8431.5,-3715284.800000001
2024-08-16,Receipt,Delta Haulage,0.0,5300.48,-3709984.320000001
2024-08-16,Receipt,Nexus Fuels,0.0,3709.1,-3706275.220000001
2024-08-16,Receipt,Cash Customer,0.0,13921.19,-3692354.030000001
2024-08-16,Receipt,Cash Customer,0.0,19269.04,-3673084.990000001
2024-08-16,Payment,Engen,21000.0,0.0,-3694084.990000001
2024-08-16,Receipt,Alpha Transport,0.0,5730.35,-3688354.640000001
2024-08-17,Payment,Engen,21400.0,0.0,-3709754.640000001
2024-08-17,Payment,Engen,23800.0,0.0,-3733554.640000001
2024-08-17,Payment,Engen,33600.0,0.0,-3767154.640000001
2024-08-17,Payment,Engen,16800.0,0.0,-3783954.640000001
2024-08-17,Payment,Engen,25200.0,0.0,-3809154.640000001
2024-08-17,Payment,Engen,32400.0,0.0,-3841554.640000001
2024-08-17,Receipt,Cash Customer,0.0,18119.37,-3823435.270000001
2024-08-17,Receipt,Cash Customer,0.0,14754.48,-3808680.790000001
2024-08-17,Receipt,Beta Logistics,0.0,11404.2,-3797276.590000001
2024-08-17,Receipt,Civic Petroleum,0.0,6828.39,-3790448.2000000007
2024-08-17,Receipt,Nexus Fuels,0.0,9977.76,-3780470.440000001
2024-08-17,Receipt,Helix Petroleum,0.0,10905.22,-3769565.2200000007
2024-08-17,Payment,Engen,17550.0,0.0,-3787115.2200000007
2024-08-18,Receipt,Cash Customer,0.0,19475.91,-3767639.3100000005
2024-08-18,Receipt,Cash Customer,0.0,28914.38,-3738724.9300000006
2024-08-18,Receipt,Omega Cargo,0.0,6683.6,-3732041.3300000005
2024-08-18,Receipt,Giga Haulers,0.0,2487.84,-3729553.4900000007
2024-08-18,Receipt,Falcon Movers,0.0,5589.96,-3723963.5300000007
2024-08-18,Payment,Engen,34500.0,0.0,-3758463.5300000007
2024-08-18,Payment,Engen,34200.0,0.0,-3792663.5300000007
2024-08-18,Payment,Engen,24800.0,0.0,-3817463.5300000007
2024-08-19,Payment,Engen,39600.0,0.0,-3857063.5300000007
2024-08-19,Receipt,Eagle Freight,0.0,9515.88,-3847547.650000001
2024-08-19,Receipt,Omega Cargo,0.0,4416.0,-3843131.650000001
2024-08-19,Receipt,Lumen Traders,0.0,4113.33,-3839018.3200000008
2024-08-19,Receipt,Beta Logistics,0.0,10625.03,-3828393.290000001
2024-08-19,Receipt,Cash Customer,0.0,23144.55,-3805248.740000001
2024-08-19,Receipt,Cash Customer,0.0,27663.4,-3777585.3400000012
2024-08-19,Payment,Engen,30000.0,0.0,-3807585.3400000012
2024-08-19,Payment,Engen,33000.0,0.0,-3840585.3400000012
2024-08-19,Payment,Engen,22800.0,0.0,-3863385.3400000012
2024-08-19,Payment,Engen,32000.0,0.0,-3895385.3400000012
2024-08-19,Payment,Engen,37800.0,0.0,-3933185.3400000012
2024-08-19,Payment,Engen,22600.0,0.0,-3955785.3400000012
2024-08-19,Payment,Engen,26000.0,0.0,-3981785.3400000012
2024-08-19,Payment,Engen,18150.0,0.0,-3999935.3400000012
2024-08-19,Payment,Engen,31750.0,0.0,-4031685.3400000012
2024-08-19,Payment,Engen,18600.0,0.0,-4050285.3400000012
2024-08-20,Receipt,Cash Customer,0.0,23471.84,-4026813.5000000014
2024-08-20,Receipt,Alpha Transport,0.0,10963.26,-4015850.2400000016
2024-08-20,Receipt,Delta Haulage,0.0,7731.75,-4008118.4900000016
2024-08-20,Receipt,Alpha Transport,0.0,4055.73,-4004062.7600000016
2024-08-20,Receipt,Helix Petroleum,0.0,3455.06,-4000607.7000000016
2024-08-20,Receipt,Lumen Traders,0.0,4617.6,-3995990.1000000015
2024-08-20,Receipt,MaxDrive Ltd,0.0,10587.92,-3985402.1800000016
2024-08-20,Payment,Engen,26250.0,0.0,-4011652.1800000016
2024-08-20,Payment,Engen,37200.0,0.0,-4048852.1800000016
2024-08-20,Receipt,Cash Customer,0.0,22388.6,-4026463.5800000015
2024-08-21,Payment,Engen,32750.0,0.0,-4059213.5800000015
2024-08-21,Payment,Engen,16500.0,0.0,-4075713.5800000015
2024-08-21,Payment,Engen,19200.0,0.0,-4094913.5800000015
2024-08-21,Receipt,Kappa Transporters,0.0,2498.06,-4092415.5200000014
2024-08-21,Receipt,Jupiter Energy,0.0,8495.97,-4083919.550000001
2024-08-21,Receipt,Eagle Freight,0.0,10469.08,-4073450.470000001
2024-08-21,Receipt,Cash Customer,0.0,17823.24,-4055627.230000001
2024-08-21,Receipt,Cash Customer,0.0,16882.3,-4038744.930000001
2024-08-21,Payment,Engen,38700.0,0.0,-4077444.930000001
2024-08-21,Receipt,Helix Petroleum,0.0,10167.04,-4067277.890000001
2024-08-22,Receipt,Cash Customer,0.0,19213.2,-4048064.690000001
2024-08-22,Payment,Engen,33000.0,0.0,-4081064.690000001
2024-08-22,Payment,Engen,35700.0,0.0,-4116764.690000001
2024-08-22,Receipt,Kappa Transporters,0.0,12308.8,-4104455.890000001
2024-08-22,Receipt,Kappa Transporters,0.0,10505.88,-4093950.010000001
2024-08-22,Receipt,Eagle Freight,0.0,3645.04,-4090304.970000001
2024-08-22,Receipt,Cash Customer,0.0,17048.63,-4073256.3400000012
2024-08-22,Receipt,Delta Haulage,0.0,8350.83,-4064905.510000001
2024-08-22,Payment,Engen,28500.0,0.0,-4093405.510000001
2024-08-23,Payment,Engen,19350.0,0.0,-4112755.510000001
2024-08-23,Payment,Engen,29000.0,0.0,-4141755.510000001
2024-08-23,Payment,Engen,25000.0,0.0,-4166755.510000001
2024-08-23,Payment,Engen,17100.0,0.0,-4183855.510000001
2024-08-23,Receipt,Ivy Fuels,0.0,9167.34,-4174688.1700000013
2024-08-23,Payment,Engen,19500.0,0.0,-4194188.1700000013
2024-08-23,Payment,Engen,16500.0,0.0,-4210688.170000002
2024-08-23,Payment,Engen,39900.0,0.0,-4250588.170000002
2024-08-23,Receipt,Cash Customer,0.0,16830.56,-4233757.610000001
2024-08-23,Receipt,Cash Customer,0.0,26161.2,-4207596.410000001
2024-08-23,Receipt,Alpha Transport,0.0,7967.03,-4199629.380000001
2024-08-23,Receipt,Giga Haulers,0.0,2096.08,-4197533.300000001
2024-08-23,Receipt,Eagle Freight,0.0,9343.16,-4188190.140000001
2024-08-23,Payment,Engen,19050.0,0.0,-4207240.140000001
2024-08-24,Receipt,Cash Customer,0.0,25240.6,-4181999.540000001
2024-08-24,Receipt,Beta Logistics,0.0,11324.3,-4170675.240000001
2024-08-24,Receipt,Eagle Freight,0.0,4559.11,-4166116.1300000013
2024-08-24,Payment,Engen,25600.0,0.0,-4191716.1300000013
2024-08-24,Payment,Engen,24600.0,0.0,-4216316.130000001
2024-08-24,Payment,Engen,26400.0,0.0,-4242716.130000001
2024-08-24,Receipt,Cash Customer,0.0,20078.7,-4222637.430000002
2024-08-24,Payment,Engen,26400.0,0.0,-4249037.430000002
2024-08-24,Payment,Engen,30750.0,0.0,-4279787.430000002
2024-08-24,Receipt,Jupiter Energy,0.0,4094.56,-4275692.870000001
2024-08-24,Receipt,Kappa Transporters,0.0,8494.0,-4267198.870000001
2024-08-24,Receipt,Beta Logistics,0.0,11910.4,-4255288.470000001
2024-08-24,Payment,Engen,30500.0,0.0,-4285788.470000001
2024-08-25,Payment,Engen,16950.0,0.0,-4302738.470000001
2024-08-25,Payment,Engen,18450.0,0.0,-4321188.470000001
2024-08-25,Payment,Engen,38400.0,0.0,-4359588.470000001
2024-08-25,Payment,Engen,19950.0,0.0,-4379538.470000001
2024-08-25,Payment,Engen,16650.0,0.0,-4396188.470000001
2024-08-25,Payment,Engen,16650.0,0.0,-4412838.470000001
2024-08-25,Payment,Engen,40200.0,0.0,-4453038.470000001
2024-08-25,Payment,Engen,23000.0,0.0,-4476038.470000001
2024-08-25,Receipt,Cash Customer,0.0,23941.74,-4452096.73
2024-08-25,Receipt,Cash Customer,0.0,23039.77,-4429056.960000001
2024-08-25,Receipt,Jupiter Energy,0.0,8568.4,-4420488.5600000005
2024-08-25,Receipt,Civic Petroleum,0.0,2443.18,-4418045.380000001
2024-08-25,Receipt,Jupiter Energy,0.0,5370.97,-4412674.41
2024-08-25,Receipt,Beta Logistics,0.0,10922.8,-4401751.610000001
2024-08-26,Payment,Engen,16800.0,0.0,-4418551.610000001
2024-08-26,Payment,Engen,17550.0,0.0,-4436101.610000001
2024-08-26,Payment,Engen,29250.0,0.0,-4465351.610000001
2024-08-26,Payment,Engen,19200.0,0.0,-4484551.610000001
2024-08-26,Receipt,Helix Petroleum,0.0,9542.52,-4475009.090000001
2024-08-26,Receipt,Omega Cargo,0.0,9105.54,-4465903.550000001
2024-08-26,Receipt,Omega Cargo,0.0,11036.8,-4454866.750000001
2024-08-26,Receipt,Cash Customer,0.0,17174.85,-4437691.9
2024-08-26,Receipt,Cash Customer,0.0,24224.93,-4413466.970000001
2024-08-26,Receipt,MaxDrive Ltd,0.0,7672.32,-4405794.65
2024-08-27,Payment,Engen,29250.0,0.0,-4435044.65
2024-08-27,Payment,Engen,39900.0,0.0,-4474944.65
2024-08-27,Payment,Engen,34200.0,0.0,-4509144.65
2024-08-27,Receipt,Alpha Transport,0.0,12293.82,-4496850.83
2024-08-27,Receipt,Jupiter Energy,0.0,7156.8,-4489694.03
2024-08-27,Receipt,MaxDrive Ltd,0.0,9367.8,-4480326.23
2024-08-27,Receipt,Lumen Traders,0.0,4354.48,-4475971.75
2024-08-27,Receipt,Helix Petroleum,0.0,6478.7,-4469493.05
2024-08-27,Receipt,Cash Customer,0.0,19612.9,-4449880.149999999
2024-08-27,Receipt,Cash Customer,0.0,26481.75,-4423398.399999999
2024-08-27,Receipt,Kappa Transporters,0.0,4865.46,-4418532.9399999995
2024-08-28,Payment,Engen,24600.0,0.0,-4443132.9399999995
2024-08-28,Payment,Engen,37200.0,0.0,-4480332.9399999995
2024-08-28,Payment,Engen,25000.0,0.0,-4505332.9399999995
2024-08-28,Payment,Engen,17400.0,0.0,-4522732.9399999995
2024-08-28,Payment,Engen,21800.0,0.0,-4544532.9399999995
2024-08-28,Payment,Engen,38100.0,0.0,-4582632.9399999995
2024-08-28,Receipt,Cash Customer,0.0,18634.8,-4563998.14
2024-08-28,Receipt,Delta Haulage,0.0,3510.45,-4560487.6899999995
2024-08-28,Receipt,Civic Petroleum,0.0,9203.04,-4551284.649999999
2024-08-28,Receipt,Eagle Freight,0.0,5827.2,-4545457.449999999
2024-08-28,Receipt,Cash Customer,0.0,18531.2,-4526926.249999999
2024-08-29,Receipt,Cash Customer,0.0,19530.08,-4507396.169999999
2024-08-29,Receipt,Cash Customer,0.0,24655.41,-4482740.759999999
2024-08-29,Receipt,MaxDrive Ltd,0.0,8155.56,-4474585.199999999
2024-08-29,Receipt,Helix Petroleum,0.0,11685.51,-4462899.6899999995
2024-08-29,Payment,Engen,19200.0,0.0,-4482099.6899999995
2024-08-29,Payment,Engen,26400.0,0.0,-4508499.6899999995
2024-08-29,Payment,Engen,24600.0,0.0,-4533099.6899999995
2024-08-29,Payment,Engen,23200.0,0.0,-4556299.6899999995
2024-08-29,Payment,Engen,39000.0,0.0,-4595299.6899999995
2024-08-29,Payment,Engen,25200.0,0.0,-4620499.6899999995
2024-08-29,Receipt,Beta Logistics,0.0,1863.4,-4618636.289999999
2024-08-29,Payment,Engen,19050.0,0.0,-4637686.289999999
2024-08-30,Payment,Engen,40200.0,0.0,-4677886.289999999
2024-08-30,Payment,Engen,34800.0,0.0,-4712686.289999999
2024-08-30,Payment,Engen,28750.0,0.0,-4741436.289999999
2024-08-30,Payment,Engen,29000.0,0.0,-4770436.289999999
2024-08-30,Receipt,Cash Customer,0.0,21213.9,-4749222.389999999
2024-08-30,Receipt,Jupiter Energy,0.0,11046.6,-4738175.789999999
2024-08-30,Receipt,Cash Customer,0.0,19489.98,-4718685.809999999
2024-08-30,Receipt,Eagle Freight,0.0,7433.9,-4711251.909999998
2024-08-30,Receipt,Falcon Movers,0.0,9026.54,-4702225.369999998
2024-08-30,Receipt,Helix Petroleum,0.0,8643.89,-4693581.479999999
2024-08-30,Receipt,Jupiter Energy,0.0,4353.42,-4689228.059999999
2024-08-30,Receipt,Nexus Fuels,0.0,12388.87,-4676839.189999999
2024-08-31,Payment,Engen,37800.0,0.0,-4714639.189999999
2024-08-31,Payment,Engen,36300.0,0.0,-4750939.189999999
2024-08-31,Payment,Engen,31250.0,0.0,-4782189.189999999
2024-08-31,Payment,Engen,24800.0,0.0,-4806989.189999999
2024-08-31,Receipt,Cash Customer,0.0,20900.23,-4786088.959999998
2024-08-31,Receipt,Cash Customer,0.0,18456.92,-4767632.039999998
2024-08-31,Receipt,Lumen Traders,0.0,11107.2,-4756524.839999998
2024-08-31,Receipt,Falcon Movers,0.0,3801.84,-4752722.999999998
2024-08-31,Receipt,Alpha Transport,0.0,3301.76,-4749421.239999998
2024-08-31,Receipt,Alpha Transport,0.0,3674.3,-4745746.939999999
2024-09-01,Payment,Engen,29500.0,0.0,-4775246.939999999
2024-09-01,Receipt,Cash Customer,0.0,15703.76,-4759543.179999999
2024-09-01,Receipt,Cash Customer,0.0,13609.57,-4745933.6099999985
2024-09-01,Receipt,Ivy Fuels,0.0,5376.95,-4740556.659999998
2024-09-01,Payment,Engen,36300.0,0.0,-4776856.659999998
2024-09-01,Receipt,Ivy Fuels,0.0,9677.65,-4767179.009999998
2024-09-01,Receipt,Kappa Transporters,0.0,8852.8,-4758326.209999998
2024-09-01,Payment,Engen,17700.0,0.0,-4776026.209999998
2024-09-01,Receipt,Eagle Freight,0.0,11758.4,-4764267.809999998
2024-09-01,Payment,Engen,33500.0,0.0,-4797767.809999998
2024-09-01,Payment,Engen,17850.0,0.0,-4815617.809999998
2024-09-02,Payment,Engen,25600.0,0.0,-4841217.809999998
2024-09-02,Payment,Engen,25800.0,0.0,-4867017.809999998
2024-09-02,Payment,Engen,37800.0,0.0,-4904817.809999998
2024-09-02,Receipt,Eagle Freight,0.0,4025.48,-4900792.329999997
2024-09-02,Payment,Engen,24800.0,0.0,-4925592.329999997
2024-09-02,Receipt,Cash Customer,0.0,19362.72,-4906229.609999998
2024-09-02,Receipt,Cash Customer,0.0,19228.56,-4887001.049999998
2024-09-02,Receipt,Falcon Movers,0.0,9449.98,-4877551.0699999975
2024-09-02,Receipt,Eagle Freight,0.0,7444.94,-4870106.129999997
2024-09-02,Receipt,Omega Cargo,0.0,6013.8,-4864092.329999997
2024-09-02,Payment,Engen,24400.0,0.0,-4888492.329999997
2024-09-03,Receipt,Falcon Movers,0.0,4454.1,-4884038.229999998
2024-09-03,Payment,Engen,29000.0,0.0,-4913038.229999998
2024-09-03,Payment,Engen,29500.0,0.0,-4942538.229999998
2024-09-03,Receipt,Nexus Fuels,0.0,3384.92,-4939153.309999998
2024-09-03,Receipt,Falcon Movers,0.0,1584.0,-4937569.309999998
2024-09-03,Receipt,Ivy Fuels,0.0,6969.0,-4930600.309999998
2024-09-03,Receipt,Cash Customer,0.0,20606.4,-4909993.909999997
2024-09-03,Receipt,Cash Customer,0.0,25796.65,-4884197.259999997
2024-09-03,Receipt,Beta Logistics,0.0,4378.73,-4879818.529999997
2024-09-03,Payment,Engen,19950.0,0.0,-4899768.529999997
2024-09-03,Payment,Engen,38400.0,0.0,-4938168.529999997
2024-09-03,Payment,Engen,36000.0,0.0,-4974168.529999997
2024-09-03,Payment,Engen,30000.0,0.0,-5004168.529999997
2024-09-04,Payment,Engen,27750.0,0.0,-5031918.529999997
2024-09-04,Receipt,Delta Haulage,0.0,2140.14,-5029778.389999997
2024-09-04,Receipt,Cash Customer,0.0,19896.8,-5009881.589999997
2024-09-04,Receipt,Cash Customer,0.0,24129.84,-4985751.749999997
2024-09-04,Receipt,Falcon Movers,0.0,11771.76,-4973979.989999997
2024-09-04,Payment,Engen,32700.0,0.0,-5006679.989999997
2024-09-04,Receipt,Civic Petroleum,0.0,11520.0,-4995159.989999997
2024-09-05,Receipt,Giga Haulers,0.0,7048.12,-4988111.869999997
2024-09-05,Receipt,Cash Customer,0.0,22743.18,-4965368.689999998
2024-09-05,Receipt,Falcon Movers,0.0,3175.48,-4962193.209999997
2024-09-05,Receipt,Eagle Freight,0.0,5774.96,-4956418.249999997
2024-09-05,Receipt,Omega Cargo,0.0,9476.4,-4946941.849999997
2024-09-05,Receipt,Helix Petroleum,0.0,3502.86,-4943438.9899999965
2024-09-05,Receipt,Delta Haulage,0.0,7981.68,-4935457.309999997
2024-09-05,Payment,Engen,24600.0,0.0,-4960057.309999997
2024-09-05,Payment,Engen,39900.0,0.0,-4999957.309999997
2024-09-05,Payment,Engen,40500.0,0.0,-5040457.309999997
2024-09-05,Receipt,Cash Customer,0.0,17556.78,-5022900.529999997
2024-09-06,Payment,Engen,19500.0,0.0,-5042400.529999997
2024-09-06,Payment,Engen,19350.0,0.0,-5061750.529999997
2024-09-06,Payment,Engen,22800.0,0.0,-5084550.529999997
2024-09-06,Receipt,Jupiter Energy,0.0,6675.06,-5077875.469999997
2024-09-06,Receipt,Omega Cargo,0.0,11488.95,-5066386.519999997
2024-09-06,Receipt,Civic Petroleum,0.0,4121.91,-5062264.609999997
2024-09-06,Receipt,Cash Customer,0.0,22111.5,-5040153.109999997
2024-09-06,Receipt,Cash Customer,0.0,25868.89,-5014284.219999997
2024-09-06,Receipt,Omega Cargo,0.0,2639.68,-5011644.539999997
2024-09-06,Receipt,Jupiter Energy,0.0,12568.93,-4999075.609999998
2024-09-07,Receipt,Eagle Freight,0.0,11317.46,-4987758.149999998
2024-09-07,Receipt,Kappa Transporters,0.0,4778.28,-4982979.869999997
2024-09-07,Receipt,Giga Haulers,0.0,3791.55,-4979188.3199999975
2024-09-07,Receipt,Alpha Transport,0.0,2334.5,-4976853.8199999975
2024-09-07,Receipt,Civic Petroleum,0.0,11640.0,-4965213.8199999975
2024-09-07,Receipt,Cash Customer,0.0,18875.2,-4946338.619999997
2024-09-07,Receipt,Cash Customer,0.0,21992.0,-4924346.619999997
2024-09-07,Payment,Engen,19050.0,0.0,-4943396.619999997
2024-09-07,Payment,Engen,29000.0,0.0,-4972396.619999997
2024-09-07,Payment,Engen,32000.0,0.0,-5004396.619999997
2024-09-07,Payment,Engen,19650.0,0.0,-5024046.619999997
2024-09-07,Payment,Engen,18150.0,0.0,-5042196.619999997
2024-09-07,Receipt,Civic Petroleum,0.0,5502.85,-5036693.769999998
2024-09-08,Payment,Engen,24000.0,0.0,-5060693.769999998
2024-09-08,Payment,Engen,18150.0,0.0,-5078843.769999998
2024-09-08,Payment,Engen,23600.0,0.0,-5102443.769999998
2024-09-08,Payment,Engen,19500.0,0.0,-5121943.769999998
2024-09-08,Receipt,Cash Customer,0.0,24133.53,-5097810.239999997
2024-09-08,Receipt,Ivy Fuels,0.0,3321.94,-5094488.299999997
2024-09-08,Receipt,Eagle Freight,0.0,10521.9,-5083966.399999997
2024-09-08,Receipt,MaxDrive Ltd,0.0,2545.2,-5081421.199999996
2024-09-08,Receipt,MaxDrive Ltd,0.0,3336.25,-5078084.949999996
2024-09-08,Receipt,MaxDrive Ltd,0.0,7913.56,-5070171.389999997
2024-09-08,Receipt,Giga Haulers,0.0,10396.5,-5059774.889999997
2024-09-08,Receipt,Cash Customer,0.0,29465.7,-5030309.189999997
2024-09-09,Payment,Engen,33900.0,0.0,-5064209.189999997
2024-09-09,Receipt,Eagle Freight,0.0,10101.27,-5054107.919999997
2024-09-09,Receipt,Delta Haulage,0.0,6021.4,-5048086.519999997
2024-09-09,Payment,Engen,32250.0,0.0,-5080336.519999997
2024-09-09,Receipt,Civic Petroleum,0.0,1917.3,-5078419.219999997
2024-09-09,Receipt,Omega Cargo,0.0,6659.85,-5071759.369999997
2024-09-09,Receipt,Cash Customer,0.0,18216.88,-5053542.489999997
2024-09-09,Receipt,Cash Customer,0.0,15645.11,-5037897.379999997
2024-09-09,Receipt,Eagle Freight,0.0,11720.05,-5026177.329999997
2024-09-09,Payment,Engen,28500.0,0.0,-5054677.329999997
2024-09-10,Receipt,Delta Haulage,0.0,5238.24,-5049439.089999997
2024-09-10,Receipt,Civic Petroleum,0.0,2321.4,-5047117.689999997
2024-09-10,Receipt,Alpha Transport,0.0,3686.72,-5043430.969999997
2024-09-10,Receipt,Cash Customer,0.0,25802.4,-5017628.569999997
2024-09-10,Receipt,Cash Customer,0.0,21895.0,-4995733.569999997
2024-09-10,Receipt,MaxDrive Ltd,0.0,8534.06,-4987199.509999997
2024-09-10,Payment,Engen,32250.0,0.0,-5019449.509999997
2024-09-10,Payment,Engen,25400.0,0.0,-5044849.509999997
2024-09-10,Payment,Engen,29750.0,0.0,-5074599.509999997
2024-09-10,Payment,Engen,17850.0,0.0,-5092449.509999997
2024-09-10,Payment,Engen,35400.0,0.0,-5127849.509999997
2024-09-10,Payment,Engen,30250.0,0.0,-5158099.509999997
2024-09-10,Payment,Engen,25400.0,0.0,-5183499.509999997
2024-09-10,Receipt,Jupiter Energy,0.0,12451.67,-5171047.839999997
2024-09-10,Payment,Engen,32250.0,0.0,-5203297.839999997
2024-09-10,Receipt,Beta Logistics,0.0,1915.95,-5201381.889999997
2024-09-11,Payment,Engen,25200.0,0.0,-5226581.889999997
2024-09-11,Payment,Engen,23200.0,0.0,-5249781.889999997
2024-09-11,Payment,Engen,23600.0,0.0,-5273381.889999997
2024-09-11,Receipt,Cash Customer,0.0,24175.62,-5249206.269999997
2024-09-11,Receipt,Cash Customer,0.0,20400.72,-5228805.549999997
2024-09-11,Receipt,Jupiter Energy,0.0,8857.68,-5219947.869999997
2024-09-11,Receipt,Kappa Transporters,0.0,2291.03,-5217656.839999997
2024-09-11,Payment,Engen,17700.0,0.0,-5235356.839999997
2024-09-11,Payment,Engen,23800.0,0.0,-5259156.839999997
2024-09-11,Receipt,Ivy Fuels,0.0,10371.42,-5248785.419999997
2024-09-11,Payment,Engen,33600.0,0.0,-5282385.419999997
2024-09-12,Payment,Engen,33750.0,0.0,-5316135.419999997
2024-09-12,Receipt,Cash Customer,0.0,25131.78,-5291003.639999997
2024-09-12,Receipt,Cash Customer,0.0,26877.96,-5264125.679999997
2024-09-12,Receipt,Omega Cargo,0.0,1817.7,-5262307.979999997
2024-09-12,Receipt,MaxDrive Ltd,0.0,8932.56,-5253375.419999997
2024-09-12,Receipt,MaxDrive Ltd,0.0,12744.6,-5240630.8199999975
2024-09-12,Receipt,Helix Petroleum,0.0,4826.3,-5235804.519999998
2024-09-12,Payment,Engen,26400.0,0.0,-5262204.519999998
2024-09-12,Receipt,Jupiter Energy,0.0,5789.2,-5256415.3199999975
2024-09-12,Receipt,Civic Petroleum,0.0,2209.35,-5254205.969999998
2024-09-13,Receipt,Lumen Traders,0.0,4953.9,-5249252.0699999975
2024-09-13,Receipt,Ivy Fuels,0.0,9172.71,-5240079.359999998
2024-09-13,Receipt,Beta Logistics,0.0,5693.29,-5234386.0699999975
2024-09-13,Receipt,Cash Customer,0.0,15338.16,-5219047.909999997
2024-09-13,Receipt,Cash Customer,0.0,19994.94,-5199052.969999997
2024-09-13,Receipt,Kappa Transporters,0.0,8540.38,-5190512.589999997
2024-09-13,Payment,Engen,36300.0,0.0,-5226812.589999997
2024-09-13,Payment,Engen,22400.0,0.0,-5249212.589999997
2024-09-13,Payment,Engen,32100.0,0.0,-5281312.589999997
2024-09-13,Payment,Engen,21600.0,0.0,-5302912.589999997
2024-09-13,Payment,Engen,32250.0,0.0,-5335162.589999997
2024-09-13,Payment,Engen,33000.0,0.0,-5368162.589999997
2024-09-13,Receipt,Eagle Freight,0.0,3371.25,-5364791.339999997
2024-09-13,Receipt,Falcon Movers,0.0,3878.55,-5360912.789999997
2024-09-14,Payment,Engen,34500.0,0.0,-5395412.789999997
2024-09-14,Receipt,Cash Customer,0.0,22680.72,-5372732.0699999975
2024-09-14,Receipt,Cash Customer,0.0,16470.74,-5356261.329999997
2024-09-14,Receipt,Falcon Movers,0.0,11179.62,-5345081.709999997
2024-09-14,Receipt,Falcon Movers,0.0,2475.72,-5342605.989999997
2024-09-14,Payment,Engen,39000.0,0.0,-5381605.989999997
2024-09-14,Payment,Engen,23000.0,0.0,-5404605.989999997
2024-09-14,Payment,Engen,36900.0,0.0,-5441505.989999997
2024-09-14,Payment,Engen,21600.0,0.0,-5463105.989999997
2024-09-14,Payment,Engen,38700.0,0.0,-5501805.989999997
2024-09-14,Payment,Engen,29000.0,0.0,-5530805.989999997
2024-09-14,Receipt,Giga Haulers,0.0,3593.73,-5527212.259999997
2024-09-15,Payment,Engen,19500.0,0.0,-5546712.259999997
2024-09-15,Payment,Engen,18000.0,0.0,-5564712.259999997
2024-09-15,Payment,Engen,25000.0,0.0,-5589712.259999997
2024-09-15,Payment,Engen,38700.0,0.0,-5628412.259999997
2024-09-15,Payment,Engen,24400.0,0.0,-5652812.259999997
2024-09-15,Payment,Engen,28000.0,0.0,-5680812.259999997
2024-09-15,Receipt,Cash Customer,0.0,18402.26,-5662409.999999997
2024-09-15,Receipt,Cash Customer,0.0,20143.2,-5642266.799999997
2024-09-15,Receipt,Delta Haulage,0.0,9924.08,-5632342.719999997
2024-09-15,Receipt,Giga Haulers,0.0,5994.3,-5626348.419999997
2024-09-15,Receipt,MaxDrive Ltd,0.0,7368.06,-5618980.359999998
2024-09-15,Receipt,Helix Petroleum,0.0,1876.05,-5617104.309999998
2024-09-16,Receipt,Jupiter Energy,0.0,7370.58,-5609733.729999998
2024-09-16,Payment,Engen,29000.0,0.0,-5638733.729999998
2024-09-16,Payment,Engen,25200.0,0.0,-5663933.729999998
2024-09-16,Payment,Engen,23000.0,0.0,-5686933.729999998
2024-09-16,Payment,Engen,25800.0,0.0,-5712733.729999998
2024-09-16,Receipt,Eagle Freight,0.0,3310.8,-5709422.929999998
2024-09-16,Payment,Engen,22200.0,0.0,-5731622.929999998
2024-09-16,Payment,Engen,17100.0,0.0,-5748722.929999998
2024-09-16,Receipt,Cash Customer,0.0,20715.38,-5728007.549999998
2024-09-16,Receipt,Cash Customer,0.0,17024.58,-5710982.969999998
2024-09-16,Receipt,Eagle Freight,0.0,5788.42,-5705194.549999998
2024-09-16,Receipt,Civic Petroleum,0.0,2393.35,-5702801.199999998
2024-09-17,Receipt,Lumen Traders,0.0,7599.9,-5695201.299999998
2024-09-17,Receipt,Civic Petroleum,0.0,5461.2,-5689740.099999998
2024-09-17,Receipt,Helix Petroleum,0.0,6571.48,-5683168.619999997
2024-09-17,Receipt,Ivy Fuels,0.0,7559.64,-5675608.979999998
2024-09-17,Receipt,Cash Customer,0.0,15727.6,-5659881.379999998
2024-09-17,Receipt,Cash Customer,0.0,27891.24,-5631990.139999998
2024-09-17,Receipt,Nexus Fuels,0.0,5188.26,-5626801.879999998
2024-09-17,Payment,Engen,34200.0,0.0,-5661001.879999998
2024-09-17,Receipt,MaxDrive Ltd,0.0,5924.88,-5655076.999999998
2024-09-17,Payment,Engen,16650.0,0.0,-5671726.999999998
2024-09-17,Payment,Engen,21400.0,0.0,-5693126.999999998
2024-09-17,Payment,Engen,39900.0,0.0,-5733026.999999998
2024-09-17,Payment,Engen,31000.0,0.0,-5764026.999999998
2024-09-17,Payment,Engen,21400.0,0.0,-5785426.999999998
2024-09-17,Payment,Engen,37500.0,0.0,-5822926.999999998
2024-09-17,Payment,Engen,30750.0,0.0,-5853676.999999998
2024-09-17,Payment,Engen,32500.0,0.0,-5886176.999999998
2024-09-18,Receipt,Giga Haulers,0.0,8467.08,-5877709.919999998
2024-09-18,Receipt,MaxDrive Ltd,0.0,6790.89,-5870919.029999998
2024-09-18,Receipt,Beta Logistics,0.0,5828.16,-5865090.869999998
2024-09-18,Receipt,Giga Haulers,0.0,9755.28,-5855335.589999998
2024-09-18,Receipt,Ivy Fuels,0.0,2654.4,-5852681.189999998
2024-09-18,Receipt,Delta Haulage,0.0,10596.15,-5842085.039999997
2024-09-18,Receipt,Cash Customer,0.0,26332.89,-5815752.149999998
2024-09-18,Payment,Engen,35400.0,0.0,-5851152.149999998
2024-09-18,Receipt,Cash Customer,0.0,22716.33,-5828435.8199999975
2024-09-18,Payment,Engen,22400.0,0.0,-5850835.8199999975
2024-09-18,Payment,Engen,30000.0,0.0,-5880835.8199999975
2024-09-18,Payment,Engen,34500.0,0.0,-5915335.8199999975
2024-09-19,Receipt,Jupiter Energy,0.0,3982.44,-5911353.379999997
2024-09-19,Receipt,Kappa Transporters,0.0,13464.0,-5897889.379999997
2024-09-19,Receipt,Beta Logistics,0.0,10561.2,-5887328.179999997
2024-09-19,Receipt,Cash Customer,0.0,14899.2,-5872428.979999997
2024-09-19,Receipt,Cash Customer,0.0,15978.24,-5856450.7399999965
2024-09-19,Receipt,Nexus Fuels,0.0,2664.55,-5853786.189999997
2024-09-19,Payment,Engen,20250.0,0.0,-5874036.189999997
2024-09-19,Payment,Engen,31250.0,0.0,-5905286.189999997
2024-09-19,Payment,Engen,25600.0,0.0,-5930886.189999997
2024-09-19,Receipt,Beta Logistics,0.0,2480.85,-5928405.339999997
2024-09-20,Receipt,Cash Customer,0.0,18529.64,-5909875.699999997
2024-09-20,Receipt,Delta Haulage,0.0,8765.67,-5901110.0299999975
2024-09-20,Receipt,Delta Haulage,0.0,10773.34,-5890336.689999998
2024-09-20,Payment,Engen,25200.0,0.0,-5915536.689999998
2024-09-20,Payment,Engen,36000.0,0.0,-5951536.689999998
2024-09-20,Receipt,Delta Haulage,0.0,9277.74,-5942258.949999997
2024-09-20,Payment,Engen,32250.0,0.0,-5974508.949999997
2024-09-20,Receipt,Delta Haulage,0.0,7416.24,-5967092.709999997
2024-09-20,Receipt,Cash Customer,0.0,24288.4,-5942804.309999997
2024-09-20,Payment,Engen,37200.0,0.0,-5980004.309999997
2024-09-20,Payment,Engen,23600.0,0.0,-6003604.309999997
2024-09-21,Payment,Engen,22800.0,0.0,-6026404.309999997
2024-09-21,Payment,Engen,23200.0,0.0,-6049604.309999997
2024-09-21,Payment,Engen,19200.0,0.0,-6068804.309999997
2024-09-21,Payment,Engen,24400.0,0.0,-6093204.309999997
2024-09-21,Payment,Engen,25600.0,0.0,-6118804.309999997
2024-09-21,Payment,Engen,22200.0,0.0,-6141004.309999997
2024-09-21,Payment,Engen,37800.0,0.0,-6178804.309999997
2024-09-21,Receipt,Cash Customer,0.0,21182.85,-6157621.459999997
2024-09-21,Receipt,Cash Customer,0.0,13279.08,-6144342.379999997
2024-09-21,Receipt,Jupiter Energy,0.0,12914.49,-6131427.889999997
2024-09-21,Receipt,Eagle Freight,0.0,6942.0,-6124485.889999997
2024-09-21,Receipt,Helix Petroleum,0.0,5051.2,-6119434.689999997
2024-09-21,Receipt,Beta Logistics,0.0,8676.72,-6110757.969999997
2024-09-21,Receipt,Civic Petroleum,0.0,4323.78,-6106434.189999997
2024-09-22,Receipt,Omega Cargo,0.0,9612.96,-6096821.229999997
2024-09-22,Receipt,Alpha Transport,0.0,4003.61,-6092817.619999996
2024-09-22,Receipt,Alpha Transport,0.0,2531.1,-6090286.519999997
2024-09-22,Payment,Engen,24800.0,0.0,-6115086.519999997
2024-09-22,Receipt,Cash Customer,0.0,16673.27,-6098413.249999997
2024-09-22,Payment,Engen,27750.0,0.0,-6126163.249999997
2024-09-22,Payment,Engen,17550.0,0.0,-6143713.249999997
2024-09-22,Payment,Engen,28500.0,0.0,-6172213.249999997
2024-09-22,Receipt,Beta Logistics,0.0,2026.44,-6170186.809999997
2024-09-22,Payment,Engen,34500.0,0.0,-6204686.809999997
2024-09-22,Receipt,Cash Customer,0.0,15802.8,-6188884.009999997
2024-09-23,Payment,Engen,24200.0,0.0,-6213084.009999997
2024-09-23,Payment,Engen,21200.0,0.0,-6234284.009999997
2024-09-23,Payment,Engen,39300.0,0.0,-6273584.009999997
2024-09-23,Payment,Engen,25800.0,0.0,-6299384.009999997
2024-09-23,Payment,Engen,27500.0,0.0,-6326884.009999997
2024-09-23,Payment,Engen,22800.0,0.0,-6349684.009999997
2024-09-23,Receipt,Cash Customer,0.0,20927.62,-6328756.389999997
2024-09-23,Receipt,Cash Customer,0.0,21330.0,-6307426.389999997
2024-09-23,Receipt,Lumen Traders,0.0,1679.9,-6305746.4899999965
2024-09-23,Receipt,MaxDrive Ltd,0.0,4504.32,-6301242.169999996
2024-09-23,Receipt,MaxDrive Ltd,0.0,4807.84,-6296434.329999996
2024-09-23,Payment,Engen,25000.0,0.0,-6321434.329999996
2024-09-24,Receipt,Jupiter Energy,0.0,5735.13,-6315699.199999996
2024-09-24,Receipt,Kappa Transporters,0.0,2313.36,-6313385.839999996
2024-09-24,Receipt,Cash Customer,0.0,20590.2,-6292795.639999996
2024-09-24,Receipt,Cash Customer,0.0,25472.19,-6267323.4499999955
2024-09-24,Receipt,Delta Haulage,0.0,10596.15,-6256727.299999995
2024-09-24,Payment,Engen,32250.0,0.0,-6288977.299999995
2024-09-24,Payment,Engen,17250.0,0.0,-6306227.299999995
2024-09-24,Payment,Engen,19650.0,0.0,-6325877.299999995
2024-09-24,Payment,Engen,28750.0,0.0,-6354627.299999995
2024-09-24,Payment,Engen,19500.0,0.0,-6374127.299999995
2024-09-24,Receipt,Eagle Freight,0.0,5534.1,-6368593.1999999955
2024-09-24,Payment,Engen,29500.0,0.0,-6398093.1999999955
2024-09-25,Payment,Engen,34200.0,0.0,-6432293.1999999955
2024-09-25,Payment,Engen,36900.0,0.0,-6469193.1999999955
2024-09-25,Payment,Engen,20100.0,0.0,-6489293.1999999955
2024-09-25,Receipt,Delta Haulage,0.0,10696.23,-6478596.969999995
2024-09-25,Receipt,Jupiter Energy,0.0,7375.5,-6471221.469999995
2024-09-25,Receipt,Cash Customer,0.0,13343.68,-6457877.789999995
2024-09-25,Receipt,Cash Customer,0.0,20983.67,-6436894.119999995
2024-09-25,Payment,Engen,30000.0,0.0,-6466894.119999995
2024-09-25,Receipt,Alpha Transport,0.0,12136.0,-6454758.119999995
2024-09-26,Receipt,Nexus Fuels,0.0,6120.03,-6448638.089999995
2024-09-26,Payment,Engen,36300.0,0.0,-6484938.089999995
2024-09-26,Receipt,Beta Logistics,0.0,10925.7,-6474012.389999995
2024-09-26,Receipt,Helix Petroleum,0.0,10346.76,-6463665.629999995
2024-09-26,Receipt,Giga Haulers,0.0,2976.38,-6460689.249999995
2024-09-26,Payment,Engen,23600.0,0.0,-6484289.249999995
2024-09-26,Receipt,Cash Customer,0.0,21653.4,-6462635.849999995
2024-09-26,Receipt,Cash Customer,0.0,24685.92,-6437949.929999995
2024-09-26,Payment,Engen,32400.0,0.0,-6470349.929999995
2024-09-26,Payment,Engen,22200.0,0.0,-6492549.929999995
2024-09-27,Receipt,Cash Customer,0.0,21231.21,-6471318.719999995
2024-09-27,Payment,Engen,25800.0,0.0,-6497118.719999995
2024-09-27,Receipt,Ivy Fuels,0.0,12054.46,-6485064.259999995
2024-09-27,Receipt,Omega Cargo,0.0,9679.08,-6475385.179999995
2024-09-27,Receipt,Beta Logistics,0.0,2189.5,-6473195.679999995
2024-09-27,Receipt,Alpha Transport,0.0,8375.29,-6464820.389999995
2024-09-27,Receipt,MaxDrive Ltd,0.0,7264.32,-6457556.069999995
2024-09-27,Receipt,Beta Logistics,0.0,2689.41,-6454866.659999995
2024-09-27,Receipt,Cash Customer,0.0,25146.59,-6429720.069999995
2024-09-28,Receipt,Cash Customer,0.0,28123.2,-6401596.8699999945
2024-09-28,Receipt,Delta Haulage,0.0,3690.0,-6397906.8699999945
2024-09-28,Receipt,Alpha Transport,0.0,11208.82,-6386698.049999994
2024-09-28,Receipt,Alpha Transport,0.0,6879.32,-6379818.729999994
2024-09-28,Receipt,Nexus Fuels,0.0,10515.86,-6369302.869999994
2024-09-28,Receipt,MaxDrive Ltd,0.0,9158.0,-6360144.869999994
2024-09-28,Receipt,Cash Customer,0.0,29776.16,-6330368.709999993
2024-09-28,Payment,Engen,21400.0,0.0,-6351768.709999993
2024-09-28,Payment,Engen,18150.0,0.0,-6369918.709999993
2024-09-28,Payment,Engen,25600.0,0.0,-6395518.709999993
2024-09-28,Payment,Engen,24800.0,0.0,-6420318.709999993
2024-09-28,Payment,Engen,37200.0,0.0,-6457518.709999993
2024-09-28,Payment,Engen,19500.0,0.0,-6477018.709999993
2024-09-29,Receipt,Beta Logistics,0.0,6012.45,-6471006.259999993
2024-09-29,Receipt,Helix Petroleum,0.0,12026.7,-6458979.559999993
2024-09-29,Receipt,MaxDrive Ltd,0.0,3958.35,-6455021.209999993
2024-09-29,Receipt,Omega Cargo,0.0,4405.04,-6450616.169999993
2024-09-29,Payment,Engen,19350.0,0.0,-6469966.169999993
2024-09-29,Payment,Engen,16650.0,0.0,-6486616.169999993
2024-09-29,Payment,Engen,37800.0,0.0,-6524416.169999993
2024-09-29,Payment,Engen,23800.0,0.0,-6548216.169999993
2024-09-29,Payment,Engen,32250.0,0.0,-6580466.169999993
2024-09-29,Receipt,Cash Customer,0.0,16425.12,-6564041.049999993
2024-09-29,Receipt,Cash Customer,0.0,17861.25,-6546179.799999993
2024-09-30,Receipt,Cash Customer,0.0,22779.86,-6523399.939999993
2024-09-30,Payment,Engen,28000.0,0.0,-6551399.939999993
2024-09-30,Receipt,Cash Customer,0.0,22779.2,-6528620.739999993
2024-09-30,Receipt,Giga Haulers,0.0,2962.5,-6525658.239999993
2024-09-30,Receipt,Alpha Transport,0.0,11063.5,-6514594.739999993
2024-09-30,Receipt,Omega Cargo,0.0,7065.0,-6507529.739999993
2024-09-30,Receipt,Delta Haulage,0.0,6547.52,-6500982.219999993
2024-09-30,Payment,Engen,31500.0,0.0,-6532482.219999993
2024-09-30,Payment,Engen,19800.0,0.0,-6552282.219999993
2024-09-30,Payment,Engen,36600.0,0.0,-6588882.219999993
2024-09-30,Payment,Engen,17250.0,0.0,-6606132.219999993
2024-09-30,Payment,Engen,16050.0,0.0,-6622182.219999993
2024-09-30,Payment,Engen,18900.0,0.0,-6641082.219999993
2024-10-01,Payment,Engen,17850.0,0.0,-6658932.219999993
2024-10-01,Payment,Engen,19050.0,0.0,-6677982.219999993
2024-10-01,Payment,Engen,32100.0,0.0,-6710082.219999993
2024-10-01,Payment,Engen,16050.0,0.0,-6726132.219999993
2024-10-01,Receipt,Nexus Fuels,0.0,11454.3,-6714677.919999993
2024-10-01,Receipt,Alpha Transport,0.0,2376.55,-6712301.369999994
2024-10-01,Receipt,Eagle Freight,0.0,11217.6,-6701083.769999994
2024-10-01,Receipt,Cash Customer,0.0,24549.28,-6676534.489999994
2024-10-01,Receipt,Cash Customer,0.0,24406.5,-6652127.989999994
2024-10-01,Payment,Engen,18900.0,0.0,-6671027.989999994
2024-10-01,Payment,Engen,33000.0,0.0,-6704027.989999994
2024-10-01,Payment,Engen,18150.0,0.0,-6722177.989999994
2024-10-02,Receipt,Eagle Freight,0.0,2363.0,-6719814.989999994
2024-10-02,Payment,Engen,36600.0,0.0,-6756414.989999994
2024-10-02,Receipt,Cash Customer,0.0,30652.0,-6725762.989999994
2024-10-02,Receipt,Cash Customer,0.0,26532.36,-6699230.629999993
2024-10-02,Receipt,Falcon Movers,0.0,11715.7,-6687514.929999993
2024-10-02,Receipt,Nexus Fuels,0.0,7010.46,-6680504.469999993
2024-10-02,Receipt,Jupiter Energy,0.0,4536.22,-6675968.2499999935
2024-10-02,Payment,Engen,22800.0,0.0,-6698768.2499999935
2024-10-02,Receipt,Lumen Traders,0.0,6849.16,-6691919.089999993
2024-10-02,Payment,Engen,32500.0,0.0,-6724419.089999993
2024-10-02,Payment,Engen,33500.0,0.0,-6757919.089999993
2024-10-02,Payment,Engen,19050.0,0.0,-6776969.089999993
2024-10-02,Payment,Engen,24600.0,0.0,-6801569.089999993
2024-10-02,Payment,Engen,17550.0,0.0,-6819119.089999993
2024-10-02,Payment,Engen,35100.0,0.0,-6854219.089999993
2024-10-03,Receipt,Cash Customer,0.0,24330.32,-6829888.769999993
2024-10-03,Receipt,Jupiter Energy,0.0,8515.68,-6821373.089999993
2024-10-03,Receipt,Helix Petroleum,0.0,9936.08,-6811437.009999993
2024-10-03,Receipt,Eagle Freight,0.0,8768.43,-6802668.579999994
2024-10-03,Receipt,Beta Logistics,0.0,3052.86,-6799615.719999993
2024-10-03,Receipt,Helix Petroleum,0.0,10147.52,-6789468.199999994
2024-10-03,Receipt,Eagle Freight,0.0,11289.66,-6778178.5399999935
2024-10-03,Receipt,Cash Customer,0.0,25457.09,-6752721.449999994
2024-10-03,Payment,Engen,21800.0,0.0,-6774521.449999994
2024-10-03,Payment,Engen,16500.0,0.0,-6791021.449999994
2024-10-03,Payment,Engen,24000.0,0.0,-6815021.449999994
2024-10-03,Payment,Engen,35400.0,0.0,-6850421.449999994
2024-10-03,Payment,Engen,19800.0,0.0,-6870221.449999994
2024-10-04,Receipt,Eagle Freight,0.0,5268.32,-6864953.129999993
2024-10-04,Receipt,Nexus Fuels,0.0,3346.2,-6861606.929999993
2024-10-04,Receipt,Cash Customer,0.0,18862.09,-6842744.839999993
2024-10-04,Receipt,Cash Customer,0.0,24850.1,-6817894.739999994
2024-10-04,Payment,Engen,31750.0,0.0,-6849644.739999994
2024-10-04,Payment,Engen,35100.0,0.0,-6884744.739999994
2024-10-04,Payment,Engen,36900.0,0.0,-6921644.739999994
2024-10-04,Receipt,Kappa Transporters,0.0,2994.04,-6918650.699999994
2024-10-04,Payment,Engen,33250.0,0.0,-6951900.699999994
2024-10-04,Payment,Engen,17100.0,0.0,-6969000.699999994
2024-10-04,Receipt,Omega Cargo,0.0,8946.6,-6960054.099999994
2024-10-05,Receipt,Nexus Fuels,0.0,2174.13,-6957879.969999994
2024-10-05,Receipt,Civic Petroleum,0.0,8301.59,-6949578.379999994
2024-10-05,Receipt,Cash Customer,0.0,26093.4,-6923484.979999994
2024-10-05,Receipt,Falcon Movers,0.0,10743.51,-6912741.469999994
2024-10-05,Payment,Engen,22000.0,0.0,-6934741.469999994
2024-10-05,Payment,Engen,22400.0,0.0,-6957141.469999994
2024-10-05,Payment,Engen,18150.0,0.0,-6975291.469999994
2024-10-05,Receipt,Omega Cargo,0.0,2138.34,-6973153.129999994
2024-10-05,Payment,Engen,24200.0,0.0,-6997353.129999994
2024-10-05,Payment,Engen,30750.0,0.0,-7028103.129999994
2024-10-05,Receipt,Cash Customer,0.0,23409.75,-7004693.379999994
2024-10-06,Payment,Engen,26200.0,0.0,-7030893.379999994
2024-10-06,Payment,Engen,25200.0,0.0,-7056093.379999994
2024-10-06,Payment,Engen,36900.0,0.0,-7092993.379999994
2024-10-06,Receipt,Falcon Movers,0.0,12336.64,-7080656.739999995
2024-10-06,Receipt,Falcon Movers,0.0,11761.52,-7068895.219999995
2024-10-06,Receipt,MaxDrive Ltd,0.0,9682.24,-7059212.979999995
2024-10-06,Payment,Engen,32250.0,0.0,-7091462.979999995
2024-10-06,Receipt,Cash Customer,0.0,24264.22,-7067198.759999995
2024-10-06,Receipt,Cash Customer,0.0,27980.16,-7039218.599999995
2024-10-06,Receipt,Kappa Transporters,0.0,9779.94,-7029438.659999995
2024-10-07,Payment,Engen,31800.0,0.0,-7061238.659999995
2024-10-07,Payment,Engen,28250.0,0.0,-7089488.659999995
2024-10-07,Payment,Engen,27750.0,0.0,-7117238.659999995
2024-10-07,Payment,Engen,17550.0,0.0,-7134788.659999995
2024-10-07,Receipt,MaxDrive Ltd,0.0,7892.8,-7126895.859999995
2024-10-07,Receipt,MaxDrive Ltd,0.0,2544.97,-7124350.889999995
2024-10-07,Payment,Engen,31500.0,0.0,-7155850.889999995
2024-10-07,Receipt,Beta Logistics,0.0,9685.06,-7146165.829999995
2024-10-07,Receipt,Helix Petroleum,0.0,2969.73,-7143196.099999995
2024-10-07,Receipt,Cash Customer,0.0,24640.2,-7118555.899999995
2024-10-07,Receipt,Cash Customer,0.0,30682.25,-7087873.649999995
2024-10-07,Receipt,Helix Petroleum,0.0,2041.3,-7085832.349999995
2024-10-08,Receipt,Cash Customer,0.0,19237.04,-7066595.309999995
2024-10-08,Receipt,Lumen Traders,0.0,3279.8,-7063315.509999995
2024-10-08,Receipt,Lumen Traders,0.0,7241.49,-7056074.019999995
2024-10-08,Receipt,Falcon Movers,0.0,5059.38,-7051014.639999995
2024-10-08,Receipt,Eagle Freight,0.0,9278.08,-7041736.559999995
2024-10-08,Receipt,Civic Petroleum,0.0,3946.84,-7037789.719999995
2024-10-08,Receipt,Cash Customer,0.0,28389.9,-7009399.819999995
2024-10-08,Payment,Engen,31500.0,0.0,-7040899.819999995
2024-10-08,Payment,Engen,19500.0,0.0,-7060399.819999995
2024-10-08,Payment,Engen,19500.0,0.0,-7079899.819999995
2024-10-08,Payment,Engen,23600.0,0.0,-7103499.819999995
2024-10-08,Payment,Engen,22000.0,0.0,-7125499.819999995
2024-10-08,Payment,Engen,37200.0,0.0,-7162699.819999995
2024-10-08,Payment,Engen,19050.0,0.0,-7181749.819999995
2024-10-09,Payment,Engen,22400.0,0.0,-7204149.819999995
2024-10-09,Receipt,Cash Customer,0.0,25492.47,-7178657.349999995
2024-10-09,Receipt,Cash Customer,0.0,25640.24,-7153017.109999995
2024-10-09,Receipt,Lumen Traders,0.0,6927.0,-7146090.109999995
2024-10-09,Receipt,Giga Haulers,0.0,3077.88,-7143012.229999995
2024-10-09,Receipt,MaxDrive Ltd,0.0,4700.92,-7138311.309999995
2024-10-09,Receipt,Kappa Transporters,0.0,8441.92,-7129869.389999995
2024-10-09,Receipt,Ivy Fuels,0.0,8680.53,-7121188.859999995
2024-10-09,Payment,Engen,19500.0,0.0,-7140688.859999995
2024-10-09,Payment,Engen,24200.0,0.0,-7164888.859999995
2024-10-09,Payment,Engen,19500.0,0.0,-7184388.859999995
2024-10-09,Payment,Engen,32750.0,0.0,-7217138.859999995
2024-10-09,Payment,Engen,29500.0,0.0,-7246638.859999995
2024-10-09,Payment,Engen,38100.0,0.0,-7284738.859999995
2024-10-10,Payment,Engen,17400.0,0.0,-7302138.859999995
2024-10-10,Payment,Engen,17700.0,0.0,-7319838.859999995
2024-10-10,Payment,Engen,35100.0,0.0,-7354938.859999995
2024-10-10,Payment,Engen,36000.0,0.0,-7390938.859999995
2024-10-10,Payment,Engen,29000.0,0.0,-7419938.859999995
2024-10-10,Payment,Engen,18750.0,0.0,-7438688.859999995
2024-10-10,Receipt,Cash Customer,0.0,17763.2,-7420925.659999995
2024-10-10,Receipt,Cash Customer,0.0,27207.6,-7393718.059999995
2024-10-10,Receipt,Helix Petroleum,0.0,3334.37,-7390383.689999995
2024-10-10,Receipt,Jupiter Energy,0.0,8407.92,-7381975.769999995
2024-10-10,Receipt,Omega Cargo,0.0,3558.0,-7378417.769999995
2024-10-10,Payment,Engen,20100.0,0.0,-7398517.769999995
2024-10-11,Receipt,Cash Customer,0.0,25980.36,-7372537.409999995
2024-10-11,Receipt,Cash Customer,0.0,23061.73,-7349475.679999994
2024-10-11,Payment,Engen,17700.0,0.0,-7367175.679999994
2024-10-11,Payment,Engen,17700.0,0.0,-7384875.679999994
2024-10-11,Payment,Engen,35400.0,0.0,-7420275.679999994
2024-10-11,Payment,Engen,37800.0,0.0,-7458075.679999994
2024-10-11,Receipt,Kappa Transporters,0.0,6652.6,-7451423.0799999945
2024-10-11,Receipt,Helix Petroleum,0.0,10198.69,-7441224.389999994
2024-10-11,Receipt,MaxDrive Ltd,0.0,5137.65,-7436086.739999994
2024-10-12,Receipt,Cash Customer,0.0,20516.8,-7415569.939999994
2024-10-12,Payment,Engen,25200.0,0.0,-7440769.939999994
2024-10-12,Receipt,Beta Logistics,0.0,8806.7,-7431963.239999994
2024-10-12,Receipt,Civic Petroleum,0.0,1621.27,-7430341.969999994
2024-10-12,Receipt,Omega Cargo,0.0,10700.13,-7419641.839999994
2024-10-12,Receipt,Jupiter Energy,0.0,6881.52,-7412760.319999995
2024-10-12,Receipt,Alpha Transport,0.0,3722.8,-7409037.519999995
2024-10-12,Receipt,MaxDrive Ltd,0.0,10232.09,-7398805.429999995
2024-10-12,Payment,Engen,20100.0,0.0,-7418905.429999995
2024-10-12,Payment,Engen,26500.0,0.0,-7445405.429999995
2024-10-12,Payment,Engen,28250.0,0.0,-7473655.429999995
2024-10-12,Payment,Engen,25200.0,0.0,-7498855.429999995
2024-10-12,Payment,Engen,34200.0,0.0,-7533055.429999995
2024-10-12,Payment,Engen,36000.0,0.0,-7569055.429999995
2024-10-12,Receipt,Cash Customer,0.0,24204.42,-7544851.009999995
2024-10-12,Payment,Engen,35700.0,0.0,-7580551.009999995
2024-10-12,Payment,Engen,32500.0,0.0,-7613051.009999995
2024-10-12,Payment,Engen,18000.0,0.0,-7631051.009999995
2024-10-13,Receipt,Cash Customer,0.0,29216.88,-7601834.129999995
2024-10-13,Payment,Engen,19800.0,0.0,-7621634.129999995
2024-10-13,Receipt,Lumen Traders,0.0,5514.12,-7616120.009999995
2024-10-13,Receipt,Alpha Transport,0.0,11397.36,-7604722.649999995
2024-10-13,Receipt,Alpha Transport,0.0,8788.24,-7595934.409999995
2024-10-13,Payment,Engen,17550.0,0.0,-7613484.409999995
2024-10-13,Receipt,Cash Customer,0.0,20821.35,-7592663.059999995
2024-10-13,Payment,Engen,34500.0,0.0,-7627163.059999995
2024-10-13,Payment,Engen,23000.0,0.0,-7650163.059999995
2024-10-13,Payment,Engen,28250.0,0.0,-7678413.059999995
2024-10-13,Payment,Engen,31750.0,0.0,-7710163.059999995
2024-10-13,Payment,Engen,37800.0,0.0,-7747963.059999995
2024-10-14,Receipt,Nexus Fuels,0.0,3610.5,-7744352.559999995
2024-10-14,Receipt,Beta Logistics,0.0,6266.7,-7738085.859999995
2024-10-14,Receipt,Kappa Transporters,0.0,3281.74,-7734804.1199999945
2024-10-14,Receipt,Beta Logistics,0.0,4626.96,-7730177.159999995
2024-10-14,Receipt,Cash Customer,0.0,22442.32,-7707734.839999994
2024-10-14,Receipt,Cash Customer,0.0,22502.81,-7685232.029999995
2024-10-14,Receipt,MaxDrive Ltd,0.0,7121.4,-7678110.629999994
2024-10-14,Receipt,Nexus Fuels,0.0,4895.61,-7673215.019999994
2024-10-14,Payment,Engen,20100.0,0.0,-7693315.019999994
2024-10-14,Payment,Engen,27500.0,0.0,-7720815.019999994
2024-10-14,Payment,Engen,24400.0,0.0,-7745215.019999994
2024-10-14,Payment,Engen,38700.0,0.0,-7783915.019999994
2024-10-14,Payment,Engen,27000.0,0.0,-7810915.019999994
2024-10-14,Payment,Engen,21400.0,0.0,-7832315.019999994
2024-10-15,Receipt,Kappa Transporters,0.0,10837.6,-7821477.419999994
2024-10-15,Payment,Engen,27500.0,0.0,-7848977.419999994
2024-10-15,Payment,Engen,25200.0,0.0,-7874177.419999994
2024-10-15,Payment,Engen,28000.0,0.0,-7902177.419999994
2024-10-15,Receipt,Alpha Transport,0.0,2015.56,-7900161.859999995
2024-10-15,Receipt,Lumen Traders,0.0,7670.95,-7892490.909999995
2024-10-15,Receipt,MaxDrive Ltd,0.0,6720.0,-7885770.909999995
2024-10-15,Receipt,Cash Customer,0.0,20661.2,-7865109.709999994
2024-10-15,Receipt,Cash Customer,0.0,16600.71,-7848508.999999994
2024-10-16,Payment,Engen,19950.0,0.0,-7868458.999999994
2024-10-16,Payment,Engen,26500.0,0.0,-7894958.999999994
2024-10-16,Receipt,Cash Customer,0.0,19936.53,-7875022.469999994
2024-10-16,Receipt,Cash Customer,0.0,18328.64,-7856693.8299999945
2024-10-16,Payment,Engen,19050.0,0.0,-7875743.8299999945
2024-10-16,Receipt,Beta Logistics,0.0,1930.4,-7873813.429999994
2024-10-16,Receipt,Delta Haulage,0.0,10385.55,-7863427.879999994
2024-10-16,Receipt,Lumen Traders,0.0,11132.03,-7852295.849999994
2024-10-16,Receipt,Kappa Transporters,0.0,6576.92,-7845718.929999994
2024-10-16,Payment,Engen,37200.0,0.0,-7882918.929999994
2024-10-16,Payment,Engen,19050.0,0.0,-7901968.929999994
2024-10-16,Receipt,Civic Petroleum,0.0,9923.48,-7892045.449999994
2024-10-16,Payment,Engen,28500.0,0.0,-7920545.449999994
2024-10-17,Payment,Engen,31250.0,0.0,-7951795.449999994
2024-10-17,Payment,Engen,34500.0,0.0,-7986295.449999994
2024-10-17,Payment,Engen,21600.0,0.0,-8007895.449999994
2024-10-17,Payment,Engen,23000.0,0.0,-8030895.449999994
2024-10-17,Payment,Engen,22400.0,0.0,-8053295.449999994
2024-10-17,Payment,Engen,31500.0,0.0,-8084795.449999994
2024-10-17,Receipt,Cash Customer,0.0,23516.6,-8061278.849999994
2024-10-17,Receipt,Cash Customer,0.0,19323.27,-8041955.5799999945
2024-10-17,Receipt,Beta Logistics,0.0,5817.6,-8036137.979999995
2024-10-17,Receipt,Ivy Fuels,0.0,7143.96,-8028994.019999995
2024-10-17,Receipt,Helix Petroleum,0.0,3087.28,-8025906.739999995
2024-10-17,Receipt,Nexus Fuels,0.0,11373.96,-8014532.779999995
2024-10-17,Receipt,Lumen Traders,0.0,9872.91,-8004659.8699999945
2024-10-17,Receipt,Jupiter Energy,0.0,10200.8,-7994459.069999995
2024-10-18,Receipt,Cash Customer,0.0,25489.75,-7968969.319999995
2024-10-18,Receipt,Helix Petroleum,0.0,1976.59,-7966992.729999995
2024-10-18,Receipt,Jupiter Energy,0.0,1905.6,-7965087.129999995
2024-10-18,Receipt,Beta Logistics,0.0,6371.13,-7958715.999999995
2024-10-18,Payment,Engen,18900.0,0.0,-7977615.999999995
2024-10-18,Payment,Engen,22000.0,0.0,-7999615.999999995
2024-10-18,Payment,Engen,27000.0,0.0,-8026615.999999995
2024-10-18,Receipt,Cash Customer,0.0,19670.04,-8006945.959999995
2024-10-19,Payment,Engen,19350.0,0.0,-8026295.959999995
2024-10-19,Receipt,Delta Haulage,0.0,2169.62,-8024126.339999995
2024-10-19,Payment,Engen,23000.0,0.0,-8047126.339999995
2024-10-19,Receipt,Kappa Transporters,0.0,6364.65,-8040761.689999995
2024-10-19,Receipt,Alpha Transport,0.0,9484.47,-8031277.219999995
2024-10-19,Receipt,Kappa Transporters,0.0,11800.98,-8019476.239999995
2024-10-19,Receipt,Beta Logistics,0.0,6410.34,-8013065.899999995
2024-10-19,Receipt,Ivy Fuels,0.0,5636.55,-8007429.349999995
2024-10-19,Receipt,Cash Customer,0.0,26107.71,-7981321.639999995
2024-10-19,Receipt,Cash Customer,0.0,24945.7,-7956375.939999995
2024-10-19,Payment,Engen,19800.0,0.0,-7976175.939999995
2024-10-19,Payment,Engen,27250.0,0.0,-8003425.939999995
2024-10-20,Receipt,Eagle Freight,0.0,7879.34,-7995546.599999995
2024-10-20,Receipt,MaxDrive Ltd,0.0,2678.24,-7992868.359999995
2024-10-20,Receipt,Lumen Traders,0.0,3845.69,-7989022.669999994
2024-10-20,Receipt,Alpha Transport,0.0,9261.56,-7979761.109999995
2024-10-20,Receipt,Cash Customer,0.0,28987.2,-7950773.909999995
2024-10-20,Receipt,Cash Customer,0.0,17038.56,-7933735.349999995
2024-10-20,Payment,Engen,37200.0,0.0,-7970935.349999995
2024-10-20,Payment,Engen,38100.0,0.0,-8009035.349999995
2024-10-20,Payment,Engen,28750.0,0.0,-8037785.349999995
2024-10-20,Payment,Engen,32000.0,0.0,-8069785.349999995
2024-10-20,Receipt,Lumen Traders,0.0,7989.12,-8061796.229999995
2024-10-20,Receipt,Alpha Transport,0.0,8875.44,-8052920.789999994
2024-10-21,Receipt,Cash Customer,0.0,20584.0,-8032336.789999994
2024-10-21,Receipt,Cash Customer,0.0,24963.08,-8007373.709999994
2024-10-21,Receipt,Nexus Fuels,0.0,3603.6,-8003770.109999995
2024-10-21,Payment,Engen,26200.0,0.0,-8029970.109999995
2024-10-21,Payment,Engen,17550.0,0.0,-8047520.109999995
2024-10-21,Receipt,Beta Logistics,0.0,4553.78,-8042966.3299999945
2024-10-21,Payment,Engen,33000.0,0.0,-8075966.3299999945
2024-10-21,Receipt,MaxDrive Ltd,0.0,4584.97,-8071381.359999995
2024-10-21,Receipt,Helix Petroleum,0.0,2902.46,-8068478.899999995
2024-10-21,Receipt,Delta Haulage,0.0,3412.11,-8065066.789999994
2024-10-21,Payment,Engen,36000.0,0.0,-8101066.789999994
2024-10-21,Payment,Engen,38400.0,0.0,-8139466.789999994
2024-10-21,Payment,Engen,35100.0,0.0,-8174566.789999994
2024-10-21,Payment,Engen,35100.0,0.0,-8209666.789999994
2024-10-21,Payment,Engen,36900.0,0.0,-8246566.789999994
2024-10-21,Receipt,Civic Petroleum,0.0,10902.63,-8235664.159999995
2024-10-22,Receipt,Beta Logistics,0.0,10643.88,-8225020.279999994
2024-10-22,Receipt,Cash Customer,0.0,24075.48,-8200944.799999993
2024-10-22,Receipt,Cash Customer,0.0,22167.64,-8178777.159999993
2024-10-22,Receipt,Nexus Fuels,0.0,5346.12,-8173431.0399999935
2024-10-22,Receipt,Eagle Freight,0.0,2802.92,-8170628.119999994
2024-10-22,Payment,Engen,31250.0,0.0,-8201878.119999994
2024-10-22,Payment,Engen,37200.0,0.0,-8239078.119999994
2024-10-22,Payment,Engen,30750.0,0.0,-8269828.119999994
2024-10-22,Payment,Engen,35400.0,0.0,-8305228.119999994
2024-10-22,Payment,Engen,23200.0,0.0,-8328428.119999994
2024-10-23,Payment,Engen,28000.0,0.0,-8356428.119999994
2024-10-23,Receipt,Ivy Fuels,0.0,5304.02,-8351124.099999994
2024-10-23,Receipt,Giga Haulers,0.0,3514.5,-8347609.599999994
2024-10-23,Receipt,MaxDrive Ltd,0.0,3399.42,-8344210.179999994
2024-10-23,Receipt,Cash Customer,0.0,20590.35,-8323619.8299999945
2024-10-23,Payment,Engen,33250.0,0.0,-8356869.8299999945
2024-10-23,Payment,Engen,25400.0,0.0,-8382269.8299999945
2024-10-23,Payment,Engen,31750.0,0.0,-8414019.829999994
2024-10-23,Payment,Engen,31500.0,0.0,-8445519.829999994
2024-10-23,Receipt,Cash Customer,0.0,21732.1,-8423787.729999995
2024-10-24,Receipt,Falcon Movers,0.0,10608.48,-8413179.249999994
2024-10-24,Receipt,Cash Customer,0.0,23988.58,-8389190.669999994
2024-10-24,Receipt,Cash Customer,0.0,20957.79,-8368232.879999995
2024-10-24,Receipt,Falcon Movers,0.0,7405.9,-8360826.979999995
2024-10-24,Receipt,Ivy Fuels,0.0,6462.4,-8354364.5799999945
2024-10-24,Receipt,Lumen Traders,0.0,5781.51,-8348583.069999995
2024-10-24,Receipt,Helix Petroleum,0.0,8776.3,-8339806.769999994
2024-10-24,Payment,Engen,16650.0,0.0,-8356456.769999994
2024-10-24,Payment,Engen,8378.0,0.0,-8364834.769999994
2024-10-24,Payment,Engen,19500.0,0.0,-8384334.769999994
2024-10-25,Receipt,MaxDrive Ltd,0.0,3211.12,-8381123.649999995
2024-10-25,Receipt,Nexus Fuels,0.0,11207.91,-8369915.739999995
2024-10-25,Receipt,Ivy Fuels,0.0,3295.36,-8366620.379999995
2024-10-25,Receipt,Falcon Movers,0.0,5202.48,-8361417.899999995
2024-10-25,Receipt,Cash Customer,0.0,25702.04,-8335715.859999996
2024-10-25,Receipt,Cash Customer,0.0,20326.7,-8315389.159999996
2024-10-25,Payment,Engen,22000.0,0.0,-8337389.159999996
2024-10-25,Payment,Engen,31750.0,0.0,-8369139.159999996
2024-10-25,Payment,Engen,23600.0,0.0,-8392739.159999996
2024-10-25,Payment,Engen,35100.0,0.0,-8427839.159999996
2024-10-25,Payment,Engen,30250.0,0.0,-8458089.159999996
2024-10-26,Receipt,Falcon Movers,0.0,2702.46,-8455386.699999996
2024-10-26,Payment,Engen,30500.0,0.0,-8485886.699999996
2024-10-26,Payment,Engen,18300.0,0.0,-8504186.699999996
2024-10-26,Payment,Engen,31500.0,0.0,-8535686.699999996
2024-10-26,Receipt,Cash Customer,0.0,18436.36,-8517250.339999996
2024-10-26,Receipt,Cash Customer,0.0,22720.36,-8494529.979999997
2024-10-26,Receipt,Eagle Freight,0.0,5990.17,-8488539.809999997
2024-10-26,Receipt,Eagle Freight,0.0,3560.94,-8484978.869999997
2024-10-27,Receipt,MaxDrive Ltd,0.0,5482.64,-8479496.229999997
2024-10-27,Receipt,Helix Petroleum,0.0,3703.11,-8475793.119999997
2024-10-27,Receipt,Civic Petroleum,0.0,8317.68,-8467475.439999998
2024-10-27,Receipt,Lumen Traders,0.0,5896.66,-8461578.779999997
2024-10-27,Receipt,Cash Customer,0.0,27702.48,-8433876.299999997
2024-10-27,Receipt,Cash Customer,0.0,16375.1,-8417501.199999997
2024-10-27,Payment,Engen,26000.0,0.0,-8443501.199999997
2024-10-27,Payment,Engen,37200.0,0.0,-8480701.199999997
2024-10-27,Payment,Engen,31000.0,0.0,-8511701.199999997
2024-10-27,Payment,Engen,19350.0,0.0,-8531051.199999997
2024-10-27,Receipt,Lumen Traders,0.0,7610.98,-8523440.219999997
2024-10-28,Payment,Engen,24000.0,0.0,-8547440.219999997
2024-10-28,Payment,Engen,30500.0,0.0,-8577940.219999997
2024-10-28,Payment,Engen,32700.0,0.0,-8610640.219999997
2024-10-28,Payment,Engen,29500.0,0.0,-8640140.219999997
2024-10-28,Payment,Engen,32400.0,0.0,-8672540.219999997
2024-10-28,Payment,Engen,30000.0,0.0,-8702540.219999997
2024-10-28,Payment,Engen,16650.0,0.0,-8719190.219999997
2024-10-28,Receipt,Cash Customer,0.0,17861.52,-8701328.699999997
2024-10-28,Payment,Engen,32700.0,0.0,-8734028.699999997
2024-10-28,Receipt,Cash Customer,0.0,24647.23,-8709381.469999997
2024-10-28,Receipt,Kappa Transporters,0.0,1633.72,-8707747.749999996
2024-10-28,Receipt,Kappa Transporters,0.0,3518.3,-8704229.449999996
2024-10-28,Receipt,Civic Petroleum,0.0,9574.32,-8694655.129999995
2024-10-28,Payment,Engen,18600.0,0.0,-8713255.129999995
2024-10-28,Payment,Engen,29750.0,0.0,-8743005.129999995
2024-10-28,Receipt,Helix Petroleum,0.0,9784.35,-8733220.779999996
2024-10-28,Payment,Engen,17700.0,0.0,-8750920.779999996
2024-10-29,Payment,Engen,26800.0,0.0,-8777720.779999996
2024-10-29,Payment,Engen,27250.0,0.0,-8804970.779999996
2024-10-29,Payment,Engen,38100.0,0.0,-8843070.779999996
2024-10-29,Payment,Engen,31250.0,0.0,-8874320.779999996
2024-10-29,Payment,Engen,24000.0,0.0,-8898320.779999996
2024-10-29,Payment,Engen,30250.0,0.0,-8928570.779999996
2024-10-29,Payment,Engen,27750.0,0.0,-8956320.779999996
2024-10-29,Payment,Engen,37200.0,0.0,-8993520.779999996
2024-10-29,Payment,Engen,33500.0,0.0,-9027020.779999996
2024-10-29,Payment,Engen,29500.0,0.0,-9056520.779999996
2024-10-29,Payment,Engen,33750.0,0.0,-9090270.779999996
2024-10-29,Receipt,Cash Customer,0.0,15509.2,-9074761.579999996
2024-10-29,Receipt,Cash Customer,0.0,19585.41,-9055176.169999996
2024-10-29,Receipt,Alpha Transport,0.0,6156.0,-9049020.169999996
2024-10-29,Receipt,Civic Petroleum,0.0,4797.03,-9044223.139999997
2024-10-29,Receipt,Giga Haulers,0.0,10312.05,-9033911.089999996
2024-10-30,Receipt,Alpha Transport,0.0,2323.89,-9031587.199999996
2024-10-30,Receipt,Beta Logistics,0.0,7122.25,-9024464.949999996
2024-10-30,Receipt,MaxDrive Ltd,0.0,3014.82,-9021450.129999995
2024-10-30,Receipt,MaxDrive Ltd,0.0,4064.06,-9017386.069999995
2024-10-30,Receipt,Helix Petroleum,0.0,9833.92,-9007552.149999995
2024-10-30,Payment,Engen,27000.0,0.0,-9034552.149999995
2024-10-30,Payment,Engen,26600.0,0.0,-9061152.149999995
2024-10-30,Payment,Engen,34500.0,0.0,-9095652.149999995
2024-10-30,Payment,Engen,34200.0,0.0,-9129852.149999995
2024-10-30,Payment,Engen,25400.0,0.0,-9155252.149999995
2024-10-30,Receipt,Cash Customer,0.0,22325.22,-9132926.929999994
2024-10-30,Receipt,Cash Customer,0.0,22256.05,-9110670.879999993
2024-10-30,Payment,Engen,33900.0,0.0,-9144570.879999993
2024-10-31,Receipt,Kappa Transporters,0.0,10230.48,-9134340.399999993
2024-10-31,Payment,Engen,24400.0,0.0,-9158740.399999993
2024-10-31,Payment,Engen,27500.0,0.0,-9186240.399999993
2024-10-31,Payment,Engen,36300.0,0.0,-9222540.399999993
2024-10-31,Payment,Engen,39000.0,0.0,-9261540.399999993
2024-10-31,Payment,Engen,21400.0,0.0,-9282940.399999993
2024-10-31,Receipt,Ivy Fuels,0.0,3574.34,-9279366.059999993
2024-10-31,Receipt,Cash Customer,0.0,27556.76,-9251809.299999993
2024-10-31,Receipt,Cash Customer,0.0,28028.49,-9223780.809999993
2024-10-31,Receipt,MaxDrive Ltd,0.0,5471.45,-9218309.359999994
2024-11-01,Payment,Engen,40200.0,0.0,-9258509.359999994
2024-11-01,Payment,Engen,17400.0,0.0,-9275909.359999994
2024-11-01,Receipt,Cash Customer,0.0,20562.3,-9255347.059999993
2024-11-01,Receipt,Cash Customer,0.0,24301.62,-9231045.439999994
2024-11-01,Receipt,Beta Logistics,0.0,2773.44,-9228271.999999994
2024-11-01,Receipt,Eagle Freight,0.0,7319.52,-9220952.479999995
2024-11-01,Receipt,Delta Haulage,0.0,11477.75,-9209474.729999995
2024-11-01,Receipt,Jupiter Energy,0.0,6227.9,-9203246.829999994
2024-11-01,Payment,Engen,22200.0,0.0,-9225446.829999994
2024-11-01,Receipt,MaxDrive Ltd,0.0,5634.72,-9219812.109999994
2024-11-01,Payment,Engen,38700.0,0.0,-9258512.109999994
2024-11-01,Payment,Engen,21200.0,0.0,-9279712.109999994
2024-11-01,Payment,Engen,28500.0,0.0,-9308212.109999994
2024-11-01,Payment,Engen,29500.0,0.0,-9337712.109999994
2024-11-01,Payment,Engen,17700.0,0.0,-9355412.109999994
2024-11-01,Payment,Engen,33600.0,0.0,-9389012.109999994
2024-11-01,Payment,Engen,18450.0,0.0,-9407462.109999994
2024-11-02,Receipt,Nexus Fuels,0.0,2251.16,-9405210.949999994
2024-11-02,Receipt,Nexus Fuels,0.0,3710.74,-9401500.209999993
2024-11-02,Receipt,Helix Petroleum,0.0,3463.32,-9398036.889999993
2024-11-02,Receipt,Nexus Fuels,0.0,3694.4,-9394342.489999993
2024-11-02,Payment,Engen,29750.0,0.0,-9424092.489999993
2024-11-02,Receipt,Cash Customer,0.0,22164.24,-9401928.249999993
2024-11-02,Receipt,Cash Customer,0.0,17640.11,-9384288.139999993
2024-11-03,Payment,Engen,31250.0,0.0,-9415538.139999993
2024-11-03,Payment,Engen,20250.0,0.0,-9435788.139999993
2024-11-03,Payment,Engen,34800.0,0.0,-9470588.139999993
2024-11-03,Payment,Engen,29500.0,0.0,-9500088.139999993
2024-11-03,Payment,Engen,27000.0,0.0,-9527088.139999993
2024-11-03,Payment,Engen,37500.0,0.0,-9564588.139999993
2024-11-03,Payment,Engen,22800.0,0.0,-9587388.139999993
2024-11-03,Receipt,Cash Customer,0.0,23227.58,-9564160.559999993
2024-11-03,Receipt,Helix Petroleum,0.0,10937.6,-9553222.959999993
2024-11-03,Receipt,Delta Haulage,0.0,4687.2,-9548535.759999994
2024-11-03,Receipt,Omega Cargo,0.0,5417.6,-9543118.159999995
2024-11-03,Receipt,Civic Petroleum,0.0,3865.4,-9539252.759999994
2024-11-03,Receipt,Kappa Transporters,0.0,3253.14,-9535999.619999994
2024-11-03,Payment,Engen,38700.0,0.0,-9574699.619999994
2024-11-03,Receipt,Alpha Transport,0.0,6627.2,-9568072.419999994
2024-11-03,Receipt,Cash Customer,0.0,26766.25,-9541306.169999994
2024-11-04,Receipt,Cash Customer,0.0,21108.78,-9520197.389999995
2024-11-04,Receipt,Cash Customer,0.0,29098.9,-9491098.489999995
2024-11-04,Receipt,Helix Petroleum,0.0,4571.7,-9486526.789999995
2024-11-04,Receipt,Alpha Transport,0.0,10975.24,-9475551.549999995
2024-11-04,Receipt,Alpha Transport,0.0,6632.28,-9468919.269999996
2024-11-04,Payment,Engen,31250.0,0.0,-9500169.269999996
2024-11-04,Payment,Engen,35400.0,0.0,-9535569.269999996
2024-11-04,Payment,Engen,31750.0,0.0,-9567319.269999996
2024-11-04,Payment,Engen,17100.0,0.0,-9584419.269999996
2024-11-04,Payment,Engen,23600.0,0.0,-9608019.269999996
2024-11-04,Payment,Engen,23600.0,0.0,-9631619.269999996
2024-11-04,Payment,Engen,35100.0,0.0,-9666719.269999996
2024-11-04,Receipt,Ivy Fuels,0.0,6342.57,-9660376.699999996
2024-11-04,Receipt,Giga Haulers,0.0,10749.79,-9649626.909999996
2024-11-05,Receipt,Cash Customer,0.0,22660.05,-9626966.859999996
2024-11-05,Receipt,Cash Customer,0.0,26571.37,-9600395.489999996
2024-11-05,Receipt,Civic Petroleum,0.0,2908.78,-9597486.709999997
2024-11-05,Receipt,Delta Haulage,0.0,7013.16,-9590473.549999997
2024-11-05,Receipt,Nexus Fuels,0.0,7533.0,-9582940.549999997
2024-11-05,Payment,Engen,16650.0,0.0,-9599590.549999997
2024-11-05,Payment,Engen,25200.0,0.0,-9624790.549999997
2024-11-05,Payment,Engen,17400.0,0.0,-9642190.549999997
2024-11-05,Payment,Engen,27500.0,0.0,-9669690.549999997
2024-11-05,Payment,Engen,19500.0,0.0,-9689190.549999997
2024-11-06,Receipt,Civic Petroleum,0.0,6363.18,-9682827.369999997
2024-11-06,Receipt,Jupiter Energy,0.0,4113.4,-9678713.969999997
2024-11-06,Receipt,Delta Haulage,0.0,2621.19,-9676092.779999997
2024-11-06,Receipt,Ivy Fuels,0.0,3443.79,-9672648.989999998
2024-11-06,Receipt,Jupiter Energy,0.0,11253.76,-9661395.229999999
2024-11-06,Receipt,Cash Customer,0.0,21576.39,-9639818.839999998
2024-11-06,Payment,Engen,33000.0,0.0,-9672818.839999998
2024-11-06,Receipt,MaxDrive Ltd,0.0,11225.61,-9661593.229999999
2024-11-06,Payment,Engen,17250.0,0.0,-9678843.229999999
2024-11-06,Payment,Engen,33500.0,0.0,-9712343.229999999
2024-11-06,Payment,Engen,39300.0,0.0,-9751643.229999999
2024-11-06,Payment,Engen,16350.0,0.0,-9767993.229999999
2024-11-06,Payment,Engen,24200.0,0.0,-9792193.229999999
2024-11-06,Payment,Engen,28000.0,0.0,-9820193.229999999
2024-11-06,Receipt,Cash Customer,0.0,26053.92,-9794139.309999999
2024-11-07,Payment,Engen,26500.0,0.0,-9820639.309999999
2024-11-07,Payment,Engen,36600.0,0.0,-9857239.309999999
2024-11-07,Receipt,Ivy Fuels,0.0,12553.39,-9844685.919999998
2024-11-07,Receipt,Cash Customer,0.0,25488.56,-9819197.359999998
2024-11-07,Receipt,Cash Customer,0.0,23913.9,-9795283.459999997
2024-11-07,Receipt,Falcon Movers,0.0,11011.98,-9784271.479999997
2024-11-07,Receipt,Ivy Fuels,0.0,3476.16,-9780795.319999997
2024-11-07,Receipt,Alpha Transport,0.0,8783.22,-9772012.099999996
2024-11-07,Receipt,Ivy Fuels,0.0,9757.8,-9762254.299999995
2024-11-08,Payment,Engen,33500.0,0.0,-9795754.299999995
2024-11-08,Payment,Engen,31500.0,0.0,-9827254.299999995
2024-11-08,Payment,Engen,36900.0,0.0,-9864154.299999995
2024-11-08,Payment,Engen,37500.0,0.0,-9901654.299999995
2024-11-08,Payment,Engen,18300.0,0.0,-9919954.299999995
2024-11-08,Receipt,Beta Logistics,0.0,10300.3,-9909653.999999994
2024-11-08,Receipt,Beta Logistics,0.0,8785.48,-9900868.519999994
2024-11-08,Receipt,Giga Haulers,0.0,7884.0,-9892984.519999994
2024-11-08,Payment,Engen,34200.0,0.0,-9927184.519999994
2024-11-08,Receipt,Cash Customer,0.0,14209.44,-9912975.079999994
2024-11-08,Receipt,Cash Customer,0.0,23883.39,-9889091.689999994
2024-11-08,Payment,Engen,33900.0,0.0,-9922991.689999994
2024-11-08,Receipt,Nexus Fuels,0.0,9095.14,-9913896.549999993
2024-11-08,Payment,Engen,39600.0,0.0,-9953496.549999993
2024-11-08,Payment,Engen,19050.0,0.0,-9972546.549999993
2024-11-09,Payment,Engen,27750.0,0.0,-10000296.549999993
2024-11-09,Payment,Engen,15900.0,0.0,-10016196.549999993
2024-11-09,Payment,Engen,25600.0,0.0,-10041796.549999993
2024-11-09,Payment,Engen,33300.0,0.0,-10075096.549999993
2024-11-09,Receipt,Cash Customer,0.0,17360.42,-10057736.129999993
2024-11-09,Receipt,Cash Customer,0.0,20285.49,-10037450.639999993
2024-11-09,Receipt,Helix Petroleum,0.0,3933.66,-10033516.979999993
2024-11-09,Receipt,Kappa Transporters,0.0,7586.32,-10025930.659999993
2024-11-09,Receipt,Alpha Transport,0.0,4313.76,-10021616.899999993
2024-11-10,Payment,Engen,32250.0,0.0,-10053866.899999993
2024-11-10,Payment,Engen,25600.0,0.0,-10079466.899999993
2024-11-10,Payment,Engen,18600.0,0.0,-10098066.899999993
2024-11-10,Receipt,Cash Customer,0.0,23286.12,-10074780.779999994
2024-11-10,Receipt,Helix Petroleum,0.0,10798.03,-10063982.749999994
2024-11-10,Payment,Engen,34800.0,0.0,-10098782.749999994
2024-11-10,Receipt,Delta Haulage,0.0,7136.14,-10091646.609999994
2024-11-10,Receipt,Giga Haulers,0.0,9120.24,-10082526.369999994
2024-11-10,Receipt,Falcon Movers,0.0,8811.78,-10073714.589999994
2024-11-10,Receipt,Cash Customer,0.0,20957.5,-10052757.089999994
2024-11-10,Payment,Engen,24400.0,0.0,-10077157.089999994
2024-11-11,Payment,Engen,34200.0,0.0,-10111357.089999994
2024-11-11,Payment,Engen,32250.0,0.0,-10143607.089999994
2024-11-11,Payment,Engen,16200.0,0.0,-10159807.089999994
2024-11-11,Payment,Engen,31750.0,0.0,-10191557.089999994
2024-11-11,Payment,Engen,33000.0,0.0,-10224557.089999994
2024-11-11,Payment,Engen,22200.0,0.0,-10246757.089999994
2024-11-11,Receipt,MaxDrive Ltd,0.0,8323.5,-10238433.589999994
2024-11-11,Receipt,Cash Customer,0.0,16902.6,-10221530.989999995
2024-11-11,Receipt,Cash Customer,0.0,23668.32,-10197862.669999994
2024-11-11,Receipt,Beta Logistics,0.0,8985.11,-10188877.559999995
2024-11-11,Receipt,MaxDrive Ltd,0.0,12058.92,-10176818.639999995
2024-11-11,Receipt,MaxDrive Ltd,0.0,10059.86,-10166758.779999996
2024-11-11,Receipt,Beta Logistics,0.0,12153.92,-10154604.859999996
2024-11-12,Receipt,Cash Customer,0.0,25935.2,-10128669.659999996
2024-11-12,Payment,Engen,38100.0,0.0,-10166769.659999996
2024-11-12,Payment,Engen,22200.0,0.0,-10188969.659999996
2024-11-12,Payment,Engen,30250.0,0.0,-10219219.659999996
2024-11-12,Payment,Engen,40500.0,0.0,-10259719.659999996
2024-11-12,Payment,Engen,23000.0,0.0,-10282719.659999996
2024-11-12,Payment,Engen,16800.0,0.0,-10299519.659999996
2024-11-12,Payment,Engen,19500.0,0.0,-10319019.659999996
2024-11-12,Receipt,Nexus Fuels,0.0,8779.2,-10310240.459999997
2024-11-12,Receipt,Cash Customer,0.0,27069.68,-10283170.779999997
2024-11-12,Receipt,Eagle Freight,0.0,10073.6,-10273097.179999998
2024-11-12,Receipt,Kappa Transporters,0.0,9688.47,-10263408.709999997
2024-11-13,Payment,Engen,38100.0,0.0,-10301508.709999997
2024-11-13,Payment,Engen,27500.0,0.0,-10329008.709999997
2024-11-13,Receipt,Giga Haulers,0.0,4542.63,-10324466.079999996
2024-11-13,Receipt,Eagle Freight,0.0,5172.72,-10319293.359999996
2024-11-13,Receipt,Cash Customer,0.0,23304.4,-10295988.959999995
2024-11-13,Receipt,Cash Customer,0.0,27937.6,-10268051.359999996
2024-11-13,Receipt,Omega Cargo,0.0,10155.6,-10257895.759999996
2024-11-13,Payment,Engen,17550.0,0.0,-10275445.759999996
2024-11-13,Payment,Engen,20250.0,0.0,-10295695.759999996
2024-11-13,Payment,Engen,24600.0,0.0,-10320295.759999996
2024-11-13,Payment,Engen,29750.0,0.0,-10350045.759999996
2024-11-13,Payment,Engen,31800.0,0.0,-10381845.759999996
2024-11-13,Payment,Engen,18900.0,0.0,-10400745.759999996
2024-11-14,Receipt,Civic Petroleum,0.0,11569.55,-10389176.209999995
2024-11-14,Receipt,Kappa Transporters,0.0,6995.04,-10382181.169999996
2024-11-14,Payment,Engen,31500.0,0.0,-10413681.169999996
2024-11-14,Receipt,Beta Logistics,0.0,3796.52,-10409884.649999997
2024-11-14,Receipt,Lumen Traders,0.0,2949.05,-10406935.599999996
2024-11-14,Receipt,Cash Customer,0.0,25090.17,-10381845.429999996
2024-11-14,Receipt,Cash Customer,0.0,17143.35,-10364702.079999996
2024-11-14,Payment,Engen,33750.0,0.0,-10398452.079999996
2024-11-14,Payment,Engen,23600.0,0.0,-10422052.079999996
2024-11-14,Payment,Engen,32500.0,0.0,-10454552.079999996
2024-11-14,Payment,Engen,30500.0,0.0,-10485052.079999996
2024-11-14,Payment,Engen,32000.0,0.0,-10517052.079999996
2024-11-14,Receipt,MaxDrive Ltd,0.0,5480.44,-10511571.639999997
2024-11-15,Payment,Engen,16800.0,0.0,-10528371.639999997
2024-11-15,Payment,Engen,19650.0,0.0,-10548021.639999997
2024-11-15,Receipt,Ivy Fuels,0.0,6496.3,-10541525.339999996
2024-11-15,Payment,Engen,38400.0,0.0,-10579925.339999996
2024-11-15,Receipt,Kappa Transporters,0.0,2533.44,-10577391.899999997
2024-11-15,Receipt,Kappa Transporters,0.0,2800.88,-10574591.019999996
2024-11-15,Receipt,Cash Customer,0.0,21523.56,-10553067.459999995
2024-11-15,Receipt,Cash Customer,0.0,23731.83,-10529335.629999995
2024-11-15,Payment,Engen,33600.0,0.0,-10562935.629999995
2024-11-15,Receipt,Civic Petroleum,0.0,10814.16,-10552121.469999995
2024-11-16,Receipt,Cash Customer,0.0,15457.61,-10536663.859999996
2024-11-16,Receipt,Omega Cargo,0.0,1543.22,-10535120.639999995
2024-11-16,Receipt,Alpha Transport,0.0,2004.3,-10533116.339999994
2024-11-16,Receipt,Falcon Movers,0.0,5402.25,-10527714.089999994
2024-11-16,Receipt,Giga Haulers,0.0,8864.4,-10518849.689999994
2024-11-16,Receipt,Helix Petroleum,0.0,7567.82,-10511281.869999994
2024-11-16,Receipt,Alpha Transport,0.0,3689.5,-10507592.369999994
2024-11-16,Receipt,Cash Customer,0.0,18302.49,-10489289.879999993
2024-11-16,Payment,Engen,40200.0,0.0,-10529489.879999993
2024-11-16,Payment,Engen,38100.0,0.0,-10567589.879999993
2024-11-16,Payment,Engen,38100.0,0.0,-10605689.879999993
2024-11-16,Payment,Engen,18750.0,0.0,-10624439.879999993
2024-11-17,Receipt,Lumen Traders,0.0,11215.05,-10613224.829999993
2024-11-17,Receipt,Falcon Movers,0.0,8653.66,-10604571.169999992
2024-11-17,Receipt,Eagle Freight,0.0,12203.61,-10592367.559999993
2024-11-17,Receipt,Delta Haulage,0.0,13142.7,-10579224.859999994
2024-11-17,Receipt,Helix Petroleum,0.0,5664.36,-10573560.499999994
2024-11-17,Receipt,Cash Customer,0.0,26568.0,-10546992.499999994
2024-11-17,Receipt,Cash Customer,0.0,24526.32,-10522466.179999994
2024-11-17,Payment,Engen,37800.0,0.0,-10560266.179999994
2024-11-17,Payment,Engen,18300.0,0.0,-10578566.179999994
2024-11-17,Payment,Engen,25000.0,0.0,-10603566.179999994
2024-11-17,Payment,Engen,34200.0,0.0,-10637766.179999994
2024-11-17,Payment,Engen,23400.0,0.0,-10661166.179999994
2024-11-18,Receipt,Beta Logistics,0.0,8992.06,-10652174.119999994
2024-11-18,Receipt,Jupiter Energy,0.0,8264.6,-10643909.519999994
2024-11-18,Receipt,Kappa Transporters,0.0,4886.74,-10639022.779999994
2024-11-18,Receipt,Civic Petroleum,0.0,7622.0,-10631400.779999994
2024-11-18,Receipt,Ivy Fuels,0.0,11418.2,-10619982.579999994
2024-11-18,Receipt,Lumen Traders,0.0,2788.52,-10617194.059999995
2024-11-18,Receipt,Cash Customer,0.0,21657.51,-10595536.549999995
2024-11-18,Payment,Engen,19650.0,0.0,-10615186.549999995
2024-11-18,Payment,Engen,22800.0,0.0,-10637986.549999995
2024-11-18,Receipt,Cash Customer,0.0,14893.2,-10623093.349999996
2024-11-19,Payment,Engen,32000.0,0.0,-10655093.349999996
2024-11-19,Receipt,Beta Logistics,0.0,5868.72,-10649224.629999995
2024-11-19,Payment,Engen,22800.0,0.0,-10672024.629999995
2024-11-19,Receipt,Giga Haulers,0.0,9385.6,-10662639.029999996
2024-11-19,Receipt,Cash Customer,0.0,26065.14,-10636573.889999995
2024-11-19,Receipt,Cash Customer,0.0,17711.63,-10618862.259999994
2024-11-19,Payment,Engen,24200.0,0.0,-10643062.259999994
2024-11-19,Payment,Engen,30250.0,0.0,-10673312.259999994
2024-11-19,Receipt,Beta Logistics,0.0,10087.14,-10663225.119999994
2024-11-20,Receipt,Eagle Freight,0.0,11851.21,-10651373.909999993
2024-11-20,Receipt,Kappa Transporters,0.0,9425.08,-10641948.829999993
2024-11-20,Receipt,Giga Haulers,0.0,4548.4,-10637400.429999992
2024-11-20,Receipt,Falcon Movers,0.0,2485.99,-10634914.439999992
2024-11-20,Receipt,Helix Petroleum,0.0,3180.6,-10631733.839999992
2024-11-20,Receipt,Cash Customer,0.0,26978.13,-10604755.709999992
2024-11-20,Receipt,Cash Customer,0.0,19218.45,-10585537.259999992
2024-11-20,Payment,Engen,25200.0,0.0,-10610737.259999992
2024-11-20,Payment,Engen,26000.0,0.0,-10636737.259999992
2024-11-20,Payment,Engen,29500.0,0.0,-10666237.259999992
2024-11-20,Payment,Engen,21200.0,0.0,-10687437.259999992
2024-11-20,Payment,Engen,36300.0,0.0,-10723737.259999992
2024-11-20,Payment,Engen,39000.0,0.0,-10762737.259999992
2024-11-20,Payment,Engen,18300.0,0.0,-10781037.259999992
2024-11-21,Receipt,Giga Haulers,0.0,10468.56,-10770568.699999992
2024-11-21,Receipt,Delta Haulage,0.0,11063.22,-10759505.479999991
2024-11-21,Receipt,Omega Cargo,0.0,2375.46,-10757130.01999999
2024-11-21,Receipt,MaxDrive Ltd,0.0,8088.33,-10749041.68999999
2024-11-21,Receipt,Jupiter Energy,0.0,5134.12,-10743907.569999991
2024-11-21,Receipt,Nexus Fuels,0.0,8184.2,-10735723.369999992
2024-11-21,Receipt,Cash Customer,0.0,29440.44,-10706282.929999992
2024-11-21,Receipt,Cash Customer,0.0,21165.3,-10685117.629999992
2024-11-21,Payment,Engen,28000.0,0.0,-10713117.629999992
2024-11-21,Payment,Engen,32750.0,0.0,-10745867.629999992
2024-11-21,Payment,Engen,36000.0,0.0,-10781867.629999992
2024-11-21,Payment,Engen,36300.0,0.0,-10818167.629999992
2024-11-21,Payment,Engen,19200.0,0.0,-10837367.629999992
2024-11-22,Receipt,Delta Haulage,0.0,10199.16,-10827168.469999991
2024-11-22,Receipt,Kappa Transporters,0.0,8969.41,-10818199.059999991
2024-11-22,Receipt,Lumen Traders,0.0,12181.52,-10806017.539999992
2024-11-22,Receipt,Civic Petroleum,0.0,2555.35,-10803462.189999992
2024-11-22,Receipt,Cash Customer,0.0,30229.92,-10773232.269999992
2024-11-22,Payment,Engen,16800.0,0.0,-10790032.269999992
2024-11-22,Payment,Engen,23400.0,0.0,-10813432.269999992
2024-11-22,Payment,Engen,29250.0,0.0,-10842682.269999992
2024-11-22,Payment,Engen,18000.0,0.0,-10860682.269999992
2024-11-22,Receipt,Cash Customer,0.0,16217.68,-10844464.589999992
2024-11-22,Payment,Engen,26750.0,0.0,-10871214.589999992
2024-11-23,Receipt,Delta Haulage,0.0,12611.2,-10858603.389999993
2024-11-23,Receipt,Delta Haulage,0.0,12070.4,-10846532.989999993
2024-11-23,Receipt,Cash Customer,0.0,29650.92,-10816882.069999993
2024-11-23,Receipt,Alpha Transport,0.0,8177.4,-10808704.669999992
2024-11-23,Receipt,Jupiter Energy,0.0,7171.85,-10801532.819999993
2024-11-23,Receipt,Cash Customer,0.0,26125.08,-10775407.739999993
2024-11-23,Payment,Engen,17550.0,0.0,-10792957.739999993
2024-11-23,Payment,Engen,38400.0,0.0,-10831357.739999993
2024-11-23,Payment,Engen,18600.0,0.0,-10849957.739999993
2024-11-23,Payment,Engen,17100.0,0.0,-10867057.739999993
2024-11-23,Payment,Engen,18300.0,0.0,-10885357.739999993
2024-11-23,Receipt,Falcon Movers,0.0,9318.21,-10876039.529999992
2024-11-23,Payment,Engen,17550.0,0.0,-10893589.529999992
2024-11-24,Payment,Engen,18900.0,0.0,-10912489.529999992
2024-11-24,Payment,Engen,26750.0,0.0,-10939239.529999992
2024-11-24,Payment,Engen,26200.0,0.0,-10965439.529999992
2024-11-24,Payment,Engen,29000.0,0.0,-10994439.529999992
2024-11-24,Receipt,Cash Customer,0.0,16868.08,-10977571.449999992
2024-11-24,Receipt,Cash Customer,0.0,23864.0,-10953707.449999992
2024-11-24,Receipt,MaxDrive Ltd,0.0,4839.45,-10948867.999999993
2024-11-24,Receipt,Eagle Freight,0.0,9247.04,-10939620.959999993
2024-11-24,Receipt,Ivy Fuels,0.0,9043.5,-10930577.459999993
2024-11-24,Receipt,Kappa Transporters,0.0,2433.0,-10928144.459999993
2024-11-24,Receipt,Omega Cargo,0.0,9982.0,-10918162.459999993
2024-11-24,Receipt,Beta Logistics,0.0,11918.06,-10906244.399999993
2024-11-25,Receipt,Eagle Freight,0.0,5638.9,-10900605.499999993
2024-11-25,Receipt,Cash Customer,0.0,29162.06,-10871443.439999992
2024-11-25,Payment,Engen,23400.0,0.0,-10894843.439999992
2024-11-25,Payment,Engen,28000.0,0.0,-10922843.439999992
2024-11-25,Payment,Engen,15750.0,0.0,-10938593.439999992
2024-11-25,Payment,Engen,27750.0,0.0,-10966343.439999992
2024-11-25,Payment,Engen,17850.0,0.0,-10984193.439999992
2024-11-25,Payment,Engen,18000.0,0.0,-11002193.439999992
2024-11-25,Receipt,Helix Petroleum,0.0,4551.75,-10997641.689999992
2024-11-25,Receipt,Cash Customer,0.0,23628.48,-10974013.209999992
2024-11-25,Receipt,Civic Petroleum,0.0,2740.23,-10971272.979999991
2024-11-26,Receipt,Cash Customer,0.0,15493.5,-10955779.479999991
2024-11-26,Payment,Engen,29750.0,0.0,-10985529.479999991
2024-11-26,Receipt,Cash Customer,0.0,18922.34,-10966607.139999991
2024-11-26,Payment,Engen,25400.0,0.0,-10992007.139999991
2024-11-26,Payment,Engen,24000.0,0.0,-11016007.139999991
2024-11-26,Payment,Engen,18750.0,0.0,-11034757.139999991
2024-11-26,Payment,Engen,31250.0,0.0,-11066007.139999991
2024-11-26,Receipt,Civic Petroleum,0.0,3024.0,-11062983.139999991
2024-11-26,Receipt,MaxDrive Ltd,0.0,11737.23,-11051245.90999999
2024-11-26,Receipt,Jupiter Energy,0.0,10548.8,-11040697.10999999
2024-11-27,Payment,Engen,31500.0,0.0,-11072197.10999999
2024-11-27,Receipt,Cash Customer,0.0,17228.87,-11054968.23999999
2024-11-27,Receipt,Cash Customer,0.0,22531.89,-11032436.34999999
2024-11-27,Receipt,Lumen Traders,0.0,2346.96,-11030089.38999999
2024-11-27,Receipt,Falcon Movers,0.0,1985.34,-11028104.04999999
2024-11-27,Receipt,Lumen Traders,0.0,7101.57,-11021002.47999999
2024-11-27,Payment,Engen,23800.0,0.0,-11044802.47999999
2024-11-27,Payment,Engen,35100.0,0.0,-11079902.47999999
2024-11-27,Payment,Engen,36300.0,0.0,-11116202.47999999
2024-11-27,Receipt,Civic Petroleum,0.0,10996.3,-11105206.179999989
2024-11-28,Payment,Engen,24400.0,0.0,-11129606.179999989
2024-11-28,Payment,Engen,22000.0,0.0,-11151606.179999989
2024-11-28,Payment,Engen,25200.0,0.0,-11176806.179999989
2024-11-28,Payment,Engen,33300.0,0.0,-11210106.179999989
2024-11-28,Receipt,Cash Customer,0.0,19612.56,-11190493.619999988
2024-11-28,Receipt,Cash Customer,0.0,29705.8,-11160787.819999987
2024-11-28,Receipt,MaxDrive Ltd,0.0,2686.0,-11158101.819999987
2024-11-28,Receipt,MaxDrive Ltd,0.0,2920.77,-11155181.049999988
2024-11-28,Receipt,Alpha Transport,0.0,5096.4,-11150084.649999987
2024-11-28,Receipt,Delta Haulage,0.0,5100.27,-11144984.379999988
2024-11-28,Payment,Engen,33000.0,0.0,-11177984.379999988
2024-11-29,Payment,Engen,23400.0,0.0,-11201384.379999988
2024-11-29,Receipt,Cash Customer,0.0,16318.42,-11185065.959999988
2024-11-29,Receipt,Cash Customer,0.0,19816.12,-11165249.839999989
2024-11-29,Receipt,Kappa Transporters,0.0,2625.38,-11162624.459999988
2024-11-29,Receipt,Eagle Freight,0.0,6955.52,-11155668.939999988
2024-11-29,Receipt,Lumen Traders,0.0,3865.6,-11151803.339999989
2024-11-29,Receipt,Alpha Transport,0.0,12664.86,-11139138.47999999
2024-11-29,Receipt,Beta Logistics,0.0,3959.48,-11135178.999999989
2024-11-29,Payment,Engen,36000.0,0.0,-11171178.999999989
2024-11-29,Payment,Engen,37200.0,0.0,-11208378.999999989
2024-11-29,Payment,Engen,21600.0,0.0,-11229978.999999989
2024-11-29,Payment,Engen,25800.0,0.0,-11255778.999999989
2024-11-29,Payment,Engen,22000.0,0.0,-11277778.999999989
2024-11-29,Payment,Engen,31000.0,0.0,-11308778.999999989
2024-11-30,Payment,Engen,28250.0,0.0,-11337028.999999989
2024-11-30,Payment,Engen,33600.0,0.0,-11370628.999999989
2024-11-30,Payment,Engen,30000.0,0.0,-11400628.999999989
2024-11-30,Payment,Engen,36000.0,0.0,-11436628.999999989
2024-11-30,Payment,Engen,33500.0,0.0,-11470128.999999989
2024-11-30,Payment,Engen,30000.0,0.0,-11500128.999999989
2024-11-30,Receipt,Cash Customer,0.0,28274.75,-11471854.249999989
2024-11-30,Receipt,Cash Customer,0.0,18994.5,-11452859.749999989
2024-11-30,Receipt,Beta Logistics,0.0,6003.84,-11446855.909999989
2024-11-30,Receipt,Alpha Transport,0.0,4529.91,-11442325.999999989
2024-11-30,Receipt,Beta Logistics,0.0,3804.64,-11438521.359999988
2024-11-30,Receipt,Jupiter Energy,0.0,3316.74,-11435204.619999988
2024-11-30,Payment,Engen,24400.0,0.0,-11459604.619999988
2024-12-01,Receipt,Ivy Fuels,0.0,11477.24,-11448127.379999988
2024-12-01,Payment,Engen,15750.0,0.0,-11463877.379999988
2024-12-01,Payment,Engen,22200.0,0.0,-11486077.379999988
2024-12-01,Payment,Engen,16350.0,0.0,-11502427.379999988
2024-12-01,Receipt,Cash Customer,0.0,27279.9,-11475147.479999987
2024-12-01,Receipt,Cash Customer,0.0,16142.4,-11459005.079999987
2024-12-01,Receipt,Lumen Traders,0.0,5294.7,-11453710.379999988
2024-12-01,Receipt,Lumen Traders,0.0,6312.0,-11447398.379999988
2024-12-01,Payment,Engen,16500.0,0.0,-11463898.379999988
2024-12-01,Receipt,Giga Haulers,0.0,3598.9,-11460299.479999987
2024-12-02,Receipt,Cash Customer,0.0,23811.19,-11436488.289999988
2024-12-02,Payment,Engen,16650.0,0.0,-11453138.289999988
2024-12-02,Payment,Engen,28250.0,0.0,-11481388.289999988
2024-12-02,Receipt,Nexus Fuels,0.0,10177.6,-11471210.689999988
2024-12-02,Receipt,Cash Customer,0.0,26733.64,-11444477.049999988
2024-12-02,Receipt,Jupiter Energy,0.0,2949.45,-11441527.599999988
2024-12-02,Payment,Engen,38400.0,0.0,-11479927.599999988
2024-12-02,Receipt,Giga Haulers,0.0,3965.46,-11475962.139999988
2024-12-02,Receipt,Kappa Transporters,0.0,11307.2,-11464654.939999988
2024-12-02,Receipt,Jupiter Energy,0.0,3782.24,-11460872.699999988
2024-12-03,Receipt,Helix Petroleum,0.0,11622.0,-11449250.699999988
2024-12-03,Receipt,Falcon Movers,0.0,5619.69,-11443631.009999989
2024-12-03,Receipt,Cash Customer,0.0,26700.8,-11416930.209999988
2024-12-03,Receipt,Cash Customer,0.0,25736.77,-11391193.439999988
2024-12-03,Payment,Engen,31500.0,0.0,-11422693.439999988
2024-12-03,Payment,Engen,19050.0,0.0,-11441743.439999988
2024-12-03,Receipt,Delta Haulage,0.0,6567.0,-11435176.439999988
2024-12-03,Payment,Engen,33000.0,0.0,-11468176.439999988
2024-12-03,Payment,Engen,27250.0,0.0,-11495426.439999988
2024-12-03,Payment,Engen,33250.0,0.0,-11528676.439999988
2024-12-03,Payment,Engen,17400.0,0.0,-11546076.439999988
2024-12-03,Payment,Engen,18600.0,0.0,-11564676.439999988
2024-12-03,Payment,Engen,31750.0,0.0,-11596426.439999988
2024-12-03,Payment,Engen,17550.0,0.0,-11613976.439999988
2024-12-03,Payment,Engen,26200.0,0.0,-11640176.439999988
2024-12-03,Payment,Engen,17250.0,0.0,-11657426.439999988
2024-12-03,Payment,Engen,33900.0,0.0,-11691326.439999988
2024-12-03,Payment,Engen,31750.0,0.0,-11723076.439999988
2024-12-03,Receipt,Falcon Movers,0.0,10830.47,-11712245.969999988
2024-12-04,Payment,Engen,26400.0,0.0,-11738645.969999988
2024-12-04,Receipt,Cash Customer,0.0,16049.04,-11722596.929999989
2024-12-04,Receipt,Beta Logistics,0.0,9438.92,-11713158.009999989
2024-12-04,Receipt,Eagle Freight,0.0,9498.4,-11703659.609999988
2024-12-04,Receipt,Beta Logistics,0.0,1788.8,-11701870.809999987
2024-12-04,Receipt,Giga Haulers,0.0,8089.6,-11693781.209999988
2024-12-04,Payment,Engen,27750.0,0.0,-11721531.209999988
2024-12-04,Payment,Engen,33600.0,0.0,-11755131.209999988
2024-12-04,Payment,Engen,27000.0,0.0,-11782131.209999988
2024-12-04,Payment,Engen,18000.0,0.0,-11800131.209999988
2024-12-04,Receipt,Cash Customer,0.0,22488.0,-11777643.209999988
2024-12-04,Payment,Engen,17400.0,0.0,-11795043.209999988
2024-12-05,Payment,Engen,19650.0,0.0,-11814693.209999988
2024-12-05,Payment,Engen,27750.0,0.0,-11842443.209999988
2024-12-05,Receipt,Omega Cargo,0.0,11736.24,-11830706.969999988
2024-12-05,Receipt,Eagle Freight,0.0,2496.42,-11828210.549999988
2024-12-05,Receipt,Lumen Traders,0.0,9547.17,-11818663.379999988
2024-12-05,Receipt,Civic Petroleum,0.0,11847.99,-11806815.389999988
2024-12-05,Receipt,Cash Customer,0.0,25712.4,-11781102.989999987
2024-12-05,Receipt,Cash Customer,0.0,27332.56,-11753770.429999987
2024-12-05,Receipt,Jupiter Energy,0.0,8973.0,-11744797.429999987
2024-12-05,Payment,Engen,22400.0,0.0,-11767197.429999987
2024-12-05,Payment,Engen,27000.0,0.0,-11794197.429999987
2024-12-05,Payment,Engen,18000.0,0.0,-11812197.429999987
2024-12-05,Payment,Engen,31250.0,0.0,-11843447.429999987
2024-12-05,Payment,Engen,32250.0,0.0,-11875697.429999987
2024-12-05,Payment,Engen,32250.0,0.0,-11907947.429999987
2024-12-06,Receipt,Alpha Transport,0.0,12141.15,-11895806.279999986
2024-12-06,Receipt,MaxDrive Ltd,0.0,6046.55,-11889759.729999986
2024-12-06,Receipt,Omega Cargo,0.0,6033.71,-11883726.019999985
2024-12-06,Payment,Engen,29000.0,0.0,-11912726.019999985
2024-12-06,Payment,Engen,33500.0,0.0,-11946226.019999985
2024-12-06,Payment,Engen,18750.0,0.0,-11964976.019999985
2024-12-06,Payment,Engen,25200.0,0.0,-11990176.019999985
2024-12-06,Receipt,Cash Customer,0.0,29028.8,-11961147.219999984
2024-12-06,Receipt,Cash Customer,0.0,13396.74,-11947750.479999984
2024-12-07,Receipt,Beta Logistics,0.0,4808.91,-11942941.569999984
2024-12-07,Receipt,Cash Customer,0.0,30655.56,-11912286.009999983
2024-12-07,Receipt,Jupiter Energy,0.0,3275.08,-11909010.929999983
2024-12-07,Receipt,Jupiter Energy,0.0,4752.44,-11904258.489999983
2024-12-07,Receipt,Ivy Fuels,0.0,1849.89,-11902408.599999983
2024-12-07,Receipt,MaxDrive Ltd,0.0,6224.22,-11896184.379999982
2024-12-07,Receipt,Civic Petroleum,0.0,8460.9,-11887723.479999982
2024-12-07,Receipt,Cash Customer,0.0,13731.3,-11873992.179999981
2024-12-07,Payment,Engen,33600.0,0.0,-11907592.179999981
2024-12-07,Payment,Engen,32750.0,0.0,-11940342.179999981
2024-12-07,Payment,Engen,36300.0,0.0,-11976642.179999981
2024-12-07,Payment,Engen,35100.0,0.0,-12011742.179999981
2024-12-07,Payment,Engen,18450.0,0.0,-12030192.179999981
2024-12-07,Payment,Engen,32250.0,0.0,-12062442.179999981
2024-12-07,Payment,Engen,26000.0,0.0,-12088442.179999981
2024-12-08,Receipt,Kappa Transporters,0.0,11052.1,-12077390.079999981
2024-12-08,Payment,Engen,38400.0,0.0,-12115790.079999981
2024-12-08,Payment,Engen,21000.0,0.0,-12136790.079999981
2024-12-08,Payment,Engen,18150.0,0.0,-12154940.079999981
2024-12-08,Receipt,Cash Customer,0.0,18252.74,-12136687.339999981
2024-12-08,Receipt,Delta Haulage,0.0,8192.26,-12128495.079999981
2024-12-08,Receipt,Ivy Fuels,0.0,8047.82,-12120447.259999981
2024-12-08,Receipt,Cash Customer,0.0,29656.72,-12090790.53999998
2024-12-08,Receipt,Falcon Movers,0.0,4057.56,-12086732.97999998
2024-12-09,Receipt,Cash Customer,0.0,18259.76,-12068473.21999998
2024-12-09,Receipt,Cash Customer,0.0,16700.98,-12051772.23999998
2024-12-09,Payment,Engen,28250.0,0.0,-12080022.23999998
2024-12-09,Payment,Engen,17550.0,0.0,-12097572.23999998
2024-12-09,Receipt,Jupiter Energy,0.0,9879.82,-12087692.41999998
2024-12-09,Receipt,Lumen Traders,0.0,10796.6,-12076895.81999998
2024-12-09,Receipt,Jupiter Energy,0.0,5197.5,-12071698.31999998
2024-12-09,Payment,Engen,25600.0,0.0,-12097298.31999998
2024-12-09,Payment,Engen,17100.0,0.0,-12114398.31999998
2024-12-10,Payment,Engen,18300.0,0.0,-12132698.31999998
2024-12-10,Payment,Engen,17100.0,0.0,-12149798.31999998
2024-12-10,Receipt,Nexus Fuels,0.0,7863.24,-12141935.07999998
2024-12-10,Receipt,Jupiter Energy,0.0,6381.26,-12135553.81999998
2024-12-10,Receipt,Cash Customer,0.0,19764.36,-12115789.45999998
2024-12-10,Receipt,Cash Customer,0.0,25829.46,-12089959.99999998
2024-12-10,Payment,Engen,25800.0,0.0,-12115759.99999998
2024-12-10,Payment,Engen,32250.0,0.0,-12148009.99999998
2024-12-10,Receipt,Beta Logistics,0.0,10836.0,-12137173.99999998
2024-12-10,Payment,Engen,24400.0,0.0,-12161573.99999998
2024-12-10,Payment,Engen,31500.0,0.0,-12193073.99999998
2024-12-10,Payment,Engen,30500.0,0.0,-12223573.99999998
2024-12-10,Payment,Engen,29250.0,0.0,-12252823.99999998
2024-12-11,Payment,Engen,22600.0,0.0,-12275423.99999998
2024-12-11,Receipt,Falcon Movers,0.0,12537.96,-12262886.039999979
2024-12-11,Receipt,Giga Haulers,0.0,3598.92,-12259287.119999979
2024-12-11,Receipt,Eagle Freight,0.0,2276.54,-12257010.57999998
2024-12-11,Receipt,Cash Customer,0.0,13355.74,-12243654.83999998
2024-12-11,Receipt,Cash Customer,0.0,26721.4,-12216933.439999979
2024-12-11,Payment,Engen,22400.0,0.0,-12239333.439999979
2024-12-11,Payment,Engen,19050.0,0.0,-12258383.439999979
2024-12-11,Payment,Engen,18450.0,0.0,-12276833.439999979
2024-12-11,Payment,Engen,35700.0,0.0,-12312533.439999979
2024-12-11,Receipt,MaxDrive Ltd,0.0,11108.84,-12301424.59999998
2024-12-12,Payment,Engen,34200.0,0.0,-12335624.59999998
2024-12-12,Receipt,Nexus Fuels,0.0,5252.92,-12330371.67999998
2024-12-12,Payment,Engen,36300.0,0.0,-12366671.67999998
2024-12-12,Receipt,Jupiter Energy,0.0,7662.08,-12359009.59999998
2024-12-12,Receipt,Eagle Freight,0.0,6016.24,-12352993.359999979
2024-12-12,Receipt,Lumen Traders,0.0,1692.18,-12351301.17999998
2024-12-12,Receipt,Cash Customer,0.0,24176.88,-12327124.299999978
2024-12-12,Receipt,Cash Customer,0.0,25605.0,-12301519.299999978
2024-12-12,Receipt,Lumen Traders,0.0,5897.44,-12295621.859999979
2024-12-12,Payment,Engen,21400.0,0.0,-12317021.859999979
2024-12-12,Payment,Engen,36000.0,0.0,-12353021.859999979
2024-12-12,Payment,Engen,36000.0,0.0,-12389021.859999979
2024-12-12,Payment,Engen,17400.0,0.0,-12406421.859999979
2024-12-12,Payment,Engen,18300.0,0.0,-12424721.859999979
2024-12-12,Payment,Engen,26400.0,0.0,-12451121.859999979
2024-12-12,Payment,Engen,30250.0,0.0,-12481371.859999979
2024-12-13,Receipt,Jupiter Energy,0.0,4963.98,-12476407.879999978
2024-12-13,Receipt,Falcon Movers,0.0,3711.75,-12472696.129999978
2024-12-13,Receipt,Nexus Fuels,0.0,4755.8,-12467940.329999978
2024-12-13,Receipt,Falcon Movers,0.0,8027.91,-12459912.419999978
2024-12-13,Receipt,Giga Haulers,0.0,6450.6,-12453461.819999978
2024-12-13,Payment,Engen,23800.0,0.0,-12477261.819999978
2024-12-13,Receipt,Cash Customer,0.0,18953.64,-12458308.179999977
2024-12-13,Receipt,Cash Customer,0.0,22124.74,-12436183.439999977
2024-12-13,Payment,Engen,37800.0,0.0,-12473983.439999977
2024-12-13,Payment,Engen,33600.0,0.0,-12507583.439999977
2024-12-14,Receipt,Delta Haulage,0.0,1590.0,-12505993.439999977
2024-12-14,Receipt,Helix Petroleum,0.0,7794.18,-12498199.259999977
2024-12-14,Receipt,Omega Cargo,0.0,7740.04,-12490459.219999978
2024-12-14,Payment,Engen,26500.0,0.0,-12516959.219999978
2024-12-14,Receipt,Eagle Freight,0.0,6555.51,-12510403.709999979
2024-12-14,Receipt,Falcon Movers,0.0,11243.28,-12499160.42999998
2024-12-14,Receipt,Cash Customer,0.0,18069.48,-12481090.949999979
2024-12-14,Receipt,Nexus Fuels,0.0,5089.5,-12476001.449999979
2024-12-14,Receipt,Cash Customer,0.0,19543.65,-12456457.799999978
2024-12-15,Receipt,Nexus Fuels,0.0,6554.75,-12449903.049999978
2024-12-15,Receipt,Cash Customer,0.0,15555.56,-12434347.489999978
2024-12-15,Receipt,Cash Customer,0.0,28926.86,-12405420.629999978
2024-12-15,Payment,Engen,29250.0,0.0,-12434670.629999978
2024-12-15,Payment,Engen,18750.0,0.0,-12453420.629999978
2024-12-15,Payment,Engen,18000.0,0.0,-12471420.629999978
2024-12-15,Payment,Engen,26800.0,0.0,-12498220.629999978
2024-12-15,Payment,Engen,25200.0,0.0,-12523420.629999978
2024-12-15,Receipt,Delta Haulage,0.0,8301.98,-12515118.649999978
2024-12-15,Receipt,Lumen Traders,0.0,11110.51,-12504008.139999978
2024-12-15,Receipt,Alpha Transport,0.0,10225.44,-12493782.699999979
2024-12-16,Receipt,Beta Logistics,0.0,4709.98,-12489072.719999978
2024-12-16,Payment,Engen,24200.0,0.0,-12513272.719999978
2024-12-16,Payment,Engen,36900.0,0.0,-12550172.719999978
2024-12-16,Payment,Engen,18900.0,0.0,-12569072.719999978
2024-12-16,Payment,Engen,19350.0,0.0,-12588422.719999978
2024-12-16,Payment,Engen,27000.0,0.0,-12615422.719999978
2024-12-16,Payment,Engen,39900.0,0.0,-12655322.719999978
2024-12-16,Receipt,Helix Petroleum,0.0,6886.4,-12648436.319999978
2024-12-16,Payment,Engen,25800.0,0.0,-12674236.319999978
2024-12-16,Payment,Engen,36600.0,0.0,-12710836.319999978
2024-12-16,Payment,Engen,19200.0,0.0,-12730036.319999978
2024-12-16,Receipt,Cash Customer,0.0,16297.7,-12713738.619999979
2024-12-16,Receipt,Giga Haulers,0.0,4458.75,-12709279.869999979
2024-12-16,Receipt,Beta Logistics,0.0,3445.91,-12705833.959999979
2024-12-16,Receipt,Civic Petroleum,0.0,10467.15,-12695366.809999978
2024-12-16,Receipt,Cash Customer,0.0,18475.76,-12676891.049999978
2024-12-16,Payment,Engen,19200.0,0.0,-12696091.049999978
2024-12-17,Receipt,Lumen Traders,0.0,5194.2,-12690896.84999998
2024-12-17,Receipt,Cash Customer,0.0,29146.32,-12661750.529999979
2024-12-17,Receipt,Cash Customer,0.0,21313.44,-12640437.08999998
2024-12-17,Receipt,Kappa Transporters,0.0,9276.84,-12631160.24999998
2024-12-17,Payment,Engen,17550.0,0.0,-12648710.24999998
2024-12-17,Payment,Engen,25200.0,0.0,-12673910.24999998
2024-12-17,Payment,Engen,18600.0,0.0,-12692510.24999998
2024-12-17,Payment,Engen,25800.0,0.0,-12718310.24999998
2024-12-17,Payment,Engen,30750.0,0.0,-12749060.24999998
2024-12-17,Payment,Engen,18450.0,0.0,-12767510.24999998
2024-12-17,Payment,Engen,36600.0,0.0,-12804110.24999998
2024-12-17,Payment,Engen,17700.0,0.0,-12821810.24999998
2024-12-17,Receipt,MaxDrive Ltd,0.0,4617.6,-12817192.64999998
2024-12-18,Receipt,Kappa Transporters,0.0,11973.64,-12805219.00999998
2024-12-18,Payment,Engen,37500.0,0.0,-12842719.00999998
2024-12-18,Payment,Engen,33900.0,0.0,-12876619.00999998
2024-12-18,Receipt,Jupiter Energy,0.0,8340.55,-12868278.459999979
2024-12-18,Receipt,Lumen Traders,0.0,8914.57,-12859363.889999978
2024-12-18,Receipt,Giga Haulers,0.0,8851.05,-12850512.839999977
2024-12-18,Receipt,Beta Logistics,0.0,3996.3,-12846516.539999977
2024-12-18,Receipt,MaxDrive Ltd,0.0,7768.8,-12838747.739999976
2024-12-18,Receipt,Cash Customer,0.0,22560.12,-12816187.619999977
2024-12-18,Receipt,Cash Customer,0.0,29760.88,-12786426.739999976
2024-12-18,Payment,Engen,39300.0,0.0,-12825726.739999976
2024-12-19,Payment,Engen,23400.0,0.0,-12849126.739999976
2024-12-19,Payment,Engen,24000.0,0.0,-12873126.739999976
2024-12-19,Payment,Engen,33500.0,0.0,-12906626.739999976
2024-12-19,Payment,Engen,33000.0,0.0,-12939626.739999976
2024-12-19,Payment,Engen,33600.0,0.0,-12973226.739999976
2024-12-19,Receipt,Beta Logistics,0.0,2769.78,-12970456.959999977
2024-12-19,Receipt,Cash Customer,0.0,29459.3,-12940997.659999976
2024-12-19,Receipt,Cash Customer,0.0,14182.48,-12926815.179999975
2024-12-19,Receipt,Nexus Fuels,0.0,7854.0,-12918961.179999975
2024-12-19,Receipt,Nexus Fuels,0.0,11590.9,-12907370.279999975
2024-12-19,Receipt,Omega Cargo,0.0,7511.0,-12899859.279999975
2024-12-20,Receipt,Cash Customer,0.0,23846.18,-12876013.099999975
2024-12-20,Payment,Engen,21800.0,0.0,-12897813.099999975
2024-12-20,Payment,Engen,15900.0,0.0,-12913713.099999975
2024-12-20,Payment,Engen,36900.0,0.0,-12950613.099999975
2024-12-20,Payment,Engen,26800.0,0.0,-12977413.099999975
2024-12-20,Payment,Engen,27250.0,0.0,-13004663.099999975
2024-12-20,Payment,Engen,31500.0,0.0,-13036163.099999975
2024-12-20,Receipt,Cash Customer,0.0,18242.07,-13017921.029999975
2024-12-20,Receipt,Ivy Fuels,0.0,12244.65,-13005676.379999975
2024-12-20,Receipt,MaxDrive Ltd,0.0,8134.0,-12997542.379999975
2024-12-20,Receipt,Kappa Transporters,0.0,9926.7,-12987615.679999975
2024-12-20,Receipt,Beta Logistics,0.0,9269.64,-12978346.039999975
2024-12-21,Receipt,Jupiter Energy,0.0,6285.24,-12972060.799999975
2024-12-21,Receipt,Eagle Freight,0.0,6241.84,-12965818.959999975
2024-12-21,Receipt,Helix Petroleum,0.0,10605.3,-12955213.659999974
2024-12-21,Receipt,Cash Customer,0.0,27561.68,-12927651.979999974
2024-12-21,Receipt,Cash Customer,0.0,23374.5,-12904277.479999974
2024-12-21,Receipt,Helix Petroleum,0.0,8848.5,-12895428.979999974
2024-12-21,Payment,Engen,23800.0,0.0,-12919228.979999974
2024-12-21,Payment,Engen,31500.0,0.0,-12950728.979999974
2024-12-21,Payment,Engen,29500.0,0.0,-12980228.979999974
2024-12-21,Payment,Engen,36600.0,0.0,-13016828.979999974
2024-12-21,Payment,Engen,29500.0,0.0,-13046328.979999974
2024-12-21,Payment,Engen,30500.0,0.0,-13076828.979999974
2024-12-21,Payment,Engen,21600.0,0.0,-13098428.979999974
2024-12-21,Payment,Engen,36900.0,0.0,-13135328.979999974
2024-12-21,Receipt,Jupiter Energy,0.0,7010.45,-13128318.529999975
2024-12-21,Payment,Engen,23800.0,0.0,-13152118.529999975
2024-12-22,Payment,Engen,23600.0,0.0,-13175718.529999975
2024-12-22,Receipt,Omega Cargo,0.0,11525.91,-13164192.619999975
2024-12-22,Receipt,Lumen Traders,0.0,5782.8,-13158409.819999974
2024-12-22,Receipt,Helix Petroleum,0.0,12722.32,-13145687.499999974
2024-12-22,Receipt,Cash Customer,0.0,26064.87,-13119622.629999975
2024-12-22,Receipt,Cash Customer,0.0,19764.56,-13099858.069999974
2024-12-22,Receipt,Delta Haulage,0.0,9530.46,-13090327.609999973
2024-12-22,Payment,Engen,38700.0,0.0,-13129027.609999973
2024-12-22,Payment,Engen,16650.0,0.0,-13145677.609999973
2024-12-22,Payment,Engen,19050.0,0.0,-13164727.609999973
2024-12-22,Payment,Engen,18000.0,0.0,-13182727.609999973
2024-12-22,Payment,Engen,22400.0,0.0,-13205127.609999973
2024-12-23,Payment,Engen,24200.0,0.0,-13229327.609999973
2024-12-23,Receipt,Cash Customer,0.0,19966.5,-13209361.109999973
2024-12-23,Receipt,Cash Customer,0.0,19481.4,-13189879.709999973
2024-12-23,Receipt,Falcon Movers,0.0,13022.07,-13176857.639999973
2024-12-23,Receipt,MaxDrive Ltd,0.0,6702.33,-13170155.309999973
2024-12-23,Receipt,MaxDrive Ltd,0.0,5505.99,-13164649.319999972
2024-12-23,Receipt,Giga Haulers,0.0,8819.27,-13155830.049999973
2024-12-23,Receipt,MaxDrive Ltd,0.0,12059.8,-13143770.249999972
2024-12-23,Payment,Engen,33900.0,0.0,-13177670.249999972
2024-12-23,Payment,Engen,19050.0,0.0,-13196720.249999972
2024-12-23,Payment,Engen,26200.0,0.0,-13222920.249999972
2024-12-23,Receipt,Delta Haulage,0.0,4340.69,-13218579.559999973
2024-12-23,Payment,Engen,36300.0,0.0,-13254879.559999973
2024-12-24,Payment,Engen,34800.0,0.0,-13289679.559999973
2024-12-24,Payment,Engen,25000.0,0.0,-13314679.559999973
2024-12-24,Payment,Engen,24000.0,0.0,-13338679.559999973
2024-12-24,Payment,Engen,30750.0,0.0,-13369429.559999973
2024-12-24,Payment,Engen,28750.0,0.0,-13398179.559999973
2024-12-24,Payment,Engen,22400.0,0.0,-13420579.559999973
2024-12-24,Payment,Engen,32750.0,0.0,-13453329.559999973
2024-12-24,Receipt,Cash Customer,0.0,20539.65,-13432789.909999972
2024-12-24,Receipt,Cash Customer,0.0,20337.52,-13412452.389999973
2024-12-24,Receipt,Omega Cargo,0.0,11097.92,-13401354.469999973
2024-12-24,Receipt,Eagle Freight,0.0,7782.4,-13393572.069999972
2024-12-24,Payment,Engen,30500.0,0.0,-13424072.069999972
2024-12-24,Receipt,Kappa Transporters,0.0,7341.18,-13416730.889999973
2024-12-24,Receipt,Omega Cargo,0.0,12287.86,-13404443.029999973
2024-12-24,Receipt,Ivy Fuels,0.0,10015.41,-13394427.619999973
2024-12-25,Receipt,Omega Cargo,0.0,5539.5,-13388888.119999973
2024-12-25,Receipt,MaxDrive Ltd,0.0,11368.08,-13377520.039999973
2024-12-25,Receipt,MaxDrive Ltd,0.0,11690.22,-13365829.819999972
2024-12-25,Receipt,Delta Haulage,0.0,11880.62,-13353949.199999973
2024-12-25,Receipt,Kappa Transporters,0.0,3785.78,-13350163.419999974
2024-12-25,Receipt,Cash Customer,0.0,17673.24,-13332490.179999974
2024-12-25,Receipt,Delta Haulage,0.0,5314.5,-13327175.679999974
2024-12-25,Payment,Engen,28750.0,0.0,-13355925.679999974
2024-12-25,Receipt,Cash Customer,0.0,29436.05,-13326489.629999973
2024-12-25,Payment,Engen,19350.0,0.0,-13345839.629999973
2024-12-25,Payment,Engen,33500.0,0.0,-13379339.629999973
2024-12-25,Payment,Engen,35100.0,0.0,-13414439.629999973
2024-12-25,Payment,Engen,24800.0,0.0,-13439239.629999973
2024-12-25,Payment,Engen,29250.0,0.0,-13468489.629999973
2024-12-26,Payment,Engen,18150.0,0.0,-13486639.629999973
2024-12-26,Payment,Engen,35400.0,0.0,-13522039.629999973
2024-12-26,Receipt,Alpha Transport,0.0,8353.75,-13513685.879999973
2024-12-26,Receipt,Falcon Movers,0.0,10071.55,-13503614.329999972
2024-12-26,Receipt,Giga Haulers,0.0,11268.0,-13492346.329999972
2024-12-26,Receipt,Cash Customer,0.0,16126.88,-13476219.449999971
2024-12-26,Receipt,Cash Customer,0.0,13013.73,-13463205.71999997
2024-12-27,Payment,Engen,22600.0,0.0,-13485805.71999997
2024-12-27,Payment,Engen,30500.0,0.0,-13516305.71999997
2024-12-27,Payment,Engen,18750.0,0.0,-13535055.71999997
2024-12-27,Payment,Engen,29000.0,0.0,-13564055.71999997
2024-12-27,Receipt,Cash Customer,0.0,17024.0,-13547031.71999997
2024-12-27,Receipt,Cash Customer,0.0,22206.6,-13524825.119999971
2024-12-27,Receipt,Jupiter Energy,0.0,10203.07,-13514622.049999971
2024-12-27,Receipt,Nexus Fuels,0.0,6473.81,-13508148.23999997
2024-12-27,Receipt,MaxDrive Ltd,0.0,7285.38,-13500862.85999997
2024-12-27,Receipt,Falcon Movers,0.0,6554.24,-13494308.61999997
2024-12-27,Receipt,Omega Cargo,0.0,12161.26,-13482147.35999997
2024-12-27,Receipt,Helix Petroleum,0.0,7349.94,-13474797.41999997
2024-12-27,Payment,Engen,34200.0,0.0,-13508997.41999997
2024-12-27,Payment,Engen,31000.0,0.0,-13539997.41999997
2024-12-27,Payment,Engen,21600.0,0.0,-13561597.41999997
2024-12-27,Payment,Engen,27000.0,0.0,-13588597.41999997
2024-12-28,Receipt,Ivy Fuels,0.0,11147.25,-13577450.16999997
2024-12-28,Receipt,Omega Cargo,0.0,5630.04,-13571820.129999971
2024-12-28,Payment,Engen,25600.0,0.0,-13597420.129999971
2024-12-28,Payment,Engen,31750.0,0.0,-13629170.129999971
2024-12-28,Payment,Engen,17250.0,0.0,-13646420.129999971
2024-12-28,Payment,Engen,24320.0,0.0,-13670740.129999971
2024-12-28,Receipt,Eagle Freight,0.0,7533.0,-13663207.129999971
2024-12-28,Receipt,Cash Customer,0.0,26557.74,-13636649.38999997
2024-12-28,Receipt,Cash Customer,0.0,15161.58,-13621487.80999997
2024-12-28,Payment,Engen,18750.0,0.0,-13640237.80999997
2024-12-29,Payment,Engen,18000.0,0.0,-13658237.80999997
2024-12-29,Payment,Engen,39300.0,0.0,-13697537.80999997
2024-12-29,Payment,Engen,24000.0,0.0,-13721537.80999997
2024-12-29,Payment,Engen,18600.0,0.0,-13740137.80999997
2024-12-29,Payment,Engen,31000.0,0.0,-13771137.80999997
2024-12-29,Payment,Engen,36900.0,0.0,-13808037.80999997
2024-12-29,Receipt,Nexus Fuels,0.0,6258.07,-13801779.73999997
2024-12-29,Receipt,Cash Customer,0.0,24267.21,-13777512.52999997
2024-12-29,Payment,Engen,30500.0,0.0,-13808012.52999997
2024-12-29,Receipt,Cash Customer,0.0,24873.6,-13783138.92999997
2024-12-29,Receipt,Jupiter Energy,0.0,3757.5,-13779381.42999997
2024-12-29,Payment,Engen,21000.0,0.0,-13800381.42999997
2024-12-29,Receipt,Omega Cargo,0.0,1780.8,-13798600.62999997
2024-12-29,Receipt,Jupiter Energy,0.0,1774.25,-13796826.37999997
2024-12-30,Payment,Engen,19200.0,0.0,-13816026.37999997
2024-12-30,Payment,Engen,38100.0,0.0,-13854126.37999997
2024-12-30,Receipt,Cash Customer,0.0,17604.36,-13836522.01999997
2024-12-30,Receipt,Delta Haulage,0.0,7199.92,-13829322.09999997
2024-12-30,Receipt,Alpha Transport,0.0,1852.6,-13827469.49999997
2024-12-30,Receipt,Civic Petroleum,0.0,6421.65,-13821047.84999997
2024-12-30,Payment,Engen,33250.0,0.0,-13854297.84999997
2024-12-30,Payment,Engen,37800.0,0.0,-13892097.84999997
2024-12-30,Receipt,Cash Customer,0.0,25747.56,-13866350.28999997
2024-12-31,Receipt,Jupiter Energy,0.0,2561.49,-13863788.79999997
2024-12-31,Payment,Engen,26400.0,0.0,-13890188.79999997
2024-12-31,Payment,Engen,24200.0,0.0,-13914388.79999997
2024-12-31,Payment,Engen,22000.0,0.0,-13936388.79999997
2024-12-31,Payment,Engen,19500.0,0.0,-13955888.79999997
2024-12-31,Payment,Engen,32250.0,0.0,-13988138.79999997
2024-12-31,Payment,Engen,16050.0,0.0,-14004188.79999997
2024-12-31,Payment,Engen,18150.0,0.0,-14022338.79999997
2024-12-31,Receipt,Ivy Fuels,0.0,6804.34,-14015534.45999997
2024-12-31,Receipt,Cash Customer,0.0,17082.96,-13998451.499999968
2024-12-31,Receipt,Cash Customer,0.0,21649.44,-13976802.059999969
2024-12-31,Receipt,Falcon Movers,0.0,7124.8,-13969677.259999968
2024-12-31,Payment,Engen,17850.0,0.0,-13987527.259999968
2024-12-31,Payment,Engen,30250.0,0.0,-14017777.259999968
